id,Generation,origin_time,destruction_time,Lifespan,Sex_check,Gnm_Len,sequence,ancestor_list
0,-1,0,0,0,0,34,"['EY', '1', 'AA', '7', 'EQ', 'AP', 'BR', 'AF', 'BM', 'AF', '1', 'AD', 'FA', 'EU', '4', 'DL', 'ED', '15', 'ER', 'AP', 'DS', 'BQ', 'AF', 'DS', 'BQ', 'AF', '2', 'EQ', 'DP', 'AP', 'BM', 'AF', 'BM', 'AF']",['0']
1,0,0,254,254,0,34,"['EY', '1', 'AA', '7', 'EQ', 'AP', 'BR', 'AF', 'BM', 'AF', '1', 'AD', 'FA', 'EU', '4', 'DL', 'ED', '15', 'ER', 'AP', 'DS', 'BQ', 'AF', 'DS', 'BQ', 'AF', '2', 'EQ', 'DP', 'AP', 'BM', 'AF', 'BM', 'AF']",['0']
2,1,13,27,14,0,34,"['EY', '1', 'AA', '7', 'EQ', 'AP', 'BR', 'AF', 'BM', 'AF', '1', 'AD', 'FA', 'EU', '4', 'DL', 'ED', '15', 'ER', 'AP', 'DS', 'BQ', 'AF', 'DS', 'BQ', 'AF', '2', 'EQ', 'DP', 'AP', 'BM', 'AF', 'BM', 'AF']",['1']
3,1,46,126,80,0,34,"['EY', '1', 'AA', '7', 'EQ', 'AP', 'BR', 'AF', 'BM', 'AF', '1', 'AD', 'FA', 'EU', '4', 'DL', 'ED', '15', 'ER', 'AP', 'DS', 'BQ', 'AF', 'DS', 'BQ', 'AF', '2', 'EQ', 'DP', 'AP', 'BM', 'AF', 'BM', 'AF']",['1']
4,2,60,74,14,0,34,"['EY', '1', 'AA', '7', 'EQ', 'AP', 'BR', 'AF', 'BM', 'AF', '1', 'AD', 'FA', 'EU', '4', 'DL', 'ED', '15', 'ER', 'AP', 'DS', 'BQ', 'AF', 'DS', 'BQ', 'AF', '2', 'EQ', 'DP', 'AP', 'BM', 'AF', 'BM', 'AF']",['3']
5,1,79,93,14,0,34,"['EY', '1', 'AA', '7', 'EQ', 'AP', 'BR', 'AF', 'BM', 'AF', '1', 'AD', 'FA', 'EU', '4', 'DL', 'ED', '15', 'ER', 'AP', 'DS', 'BQ', 'AF', 'DS', 'BQ', 'AF', '2', 'EQ', 'DP', 'AP', 'BM', 'AF', 'BM', 'AF']",['1']
6,2,93,301,208,0,34,"['EY', '1', 'AA', '7', 'EQ', 'AP', 'BR', 'AF', 'BM', 'AF', '1', 'AD', 'FA', 'EU', '4', 'DL', 'ED', '15', 'ER', 'AP', 'DS', 'BQ', 'AF', 'DS', 'BQ', 'AF', '2', 'EQ', 'DP', 'AP', 'BM', 'AF', 'BM', 'AF']",['3']
7,1,112,254,142,0,34,"['EY', '1', 'AA', '7', 'EQ', 'AP', 'BR', 'AF', 'BM', 'AF', '1', 'AD', 'FA', 'EU', '4', 'DL', 'ED', '15', 'ER', 'AP', 'DS', 'BQ', 'AF', 'DS', 'BQ', 'AF', '2', 'EQ', 'DP', 'AP', 'BM', 'AF', 'BM', 'AF']",['1']
8,2,126,240,114,0,34,"['EY', '1', 'AA', '7', 'EQ', 'AP', 'BR', 'AF', 'BM', 'AF', '1', 'AD', 'FA', 'EU', '4', 'DL', 'ED', '15', 'ER', 'AP', 'DS', 'BQ', 'AF', 'DS', 'BQ', 'AF', '2', 'EQ', 'DP', 'AP', 'BM', 'AF', 'BM', 'AF']",['7']
9,3,140,154,14,0,34,"['EY', '1', 'AA', '7', 'EQ', 'AP', 'BR', 'AF', 'BM', 'AF', '1', 'AD', 'FA', 'EU', '4', 'DL', 'ED', '15', 'ER', 'AP', 'DS', 'BQ', 'AF', 'DS', 'BQ', 'AF', '2', 'EQ', 'DP', 'AP', 'BM', 'AF', 'BM', 'AF']",['6']
10,3,140,211,71,0,34,"['EY', '1', 'AA', '7', 'EQ', 'AP', 'BR', 'AF', 'BM', 'AF', '1', 'AD', 'FA', 'EU', '4', 'DL', 'ED', '15', 'ER', 'AP', 'DS', 'BQ', 'AF', 'DS', 'BQ', 'AF', '2', 'EQ', 'DP', 'AP', 'BM', 'AF', 'BM', 'AF']",['8']
11,1,145,437,292,0,34,"['EY', '1', 'AA', '7', 'EQ', 'AP', 'BR', 'AF', 'BM', 'AF', '1', 'AD', 'FA', 'EU', '4', 'DL', 'ED', '15', 'ER', 'AP', 'DS', 'BQ', 'AF', 'DS', 'BQ', 'AF', '2', 'EQ', 'DP', 'AP', 'BM', 'AF', 'BM', 'AF']",['1']
12,4,154,202,48,0,34,"['EY', '1', 'AA', '7', 'EQ', 'AP', 'BR', 'AF', 'BM', 'AF', '1', 'AD', 'FA', 'EU', '4', 'DL', 'ED', '15', 'ER', 'AP', 'DS', 'BQ', 'AF', 'DS', 'BQ', 'AF', '2', 'EQ', 'DP', 'AP', 'BM', 'AF', 'BM', 'AF']",['10']
13,2,159,192,33,0,34,"['EY', '1', 'AA', '7', 'EQ', 'AP', 'BR', 'AF', 'BM', 'AF', '1', 'AD', 'FA', 'EU', '4', 'DL', 'ED', '15', 'ER', 'AP', 'DS', 'BQ', 'AF', 'DS', 'BQ', 'AF', '2', 'EQ', 'DP', 'AP', 'BM', 'AF', 'BM', 'AF']",['7']
14,2,159,173,14,0,34,"['EY', '1', 'AA', '7', 'EQ', 'AP', 'BR', 'AF', 'BM', 'AF', '1', 'AD', 'FA', 'EU', '4', 'DL', 'ED', '15', 'ER', 'AP', 'DS', 'BQ', 'AF', 'DS', 'BQ', 'AF', '2', 'EQ', 'DP', 'AP', 'BM', 'AF', 'BM', 'AF']",['11']
15,5,168,246,78,0,34,"['EY', '1', 'AA', '7', 'EQ', 'AP', 'BR', 'AF', 'BM', 'AF', '1', 'AD', 'FA', 'EU', '4', 'DL', 'ED', '15', 'ER', 'AP', 'DS', 'BQ', 'AF', 'DS', 'BQ', 'AF', '2', 'EQ', 'DP', 'AP', 'BM', 'AF', 'BM', 'AF']",['12']
16,3,173,207,34,0,34,"['EY', '1', 'AA', '7', 'EQ', 'AP', 'BR', 'AF', 'BM', 'AF', '1', 'AD', 'FA', 'EU', '4', 'DL', 'ED', '15', 'ER', 'AP', 'DS', 'BQ', 'AF', 'DS', 'BQ', 'AF', '2', 'EQ', 'DP', 'AP', 'BM', 'AF', 'BM', 'AF']",['6']
17,3,173,312,139,0,34,"['EY', '1', 'AA', '7', 'EQ', 'AP', 'BR', 'AF', 'BM', 'AF', '1', 'AD', 'FA', 'EU', '4', 'DL', 'ED', '15', 'ER', 'AP', 'DS', 'BQ', 'AF', 'DS', 'BQ', 'AF', '2', 'EQ', 'DP', 'AP', 'BM', 'AF', 'BM', 'AF']",['8']
18,3,173,206,33,0,34,"['EY', '1', 'AA', '7', 'EQ', 'AP', 'BR', 'AF', 'BM', 'AF', '1', 'AD', 'FA', 'EU', '4', 'DL', 'ED', '15', 'ER', 'AP', 'DS', 'BQ', 'AF', 'DS', 'BQ', 'AF', '2', 'EQ', 'DP', 'AP', 'BM', 'AF', 'BM', 'AF']",['13']
19,1,178,386,208,0,34,"['EY', '1', 'AA', '7', 'EQ', 'AP', 'BR', 'AF', 'BM', 'AF', '1', 'AD', 'FA', 'EU', '4', 'DL', 'ED', '15', 'ER', 'AP', 'DS', 'BQ', 'AF', 'DS', 'BQ', 'AF', '2', 'EQ', 'DP', 'AP', 'BM', 'AF', 'BM', 'AF']",['1']
20,6,182,324,142,0,34,"['EY', '1', 'AA', '7', 'EQ', 'AP', 'BR', 'AF', 'BM', 'AF', '1', 'AD', 'FA', 'EU', '4', 'DL', 'ED', '15', 'ER', 'AP', 'DS', 'BQ', 'AF', 'DS', 'BQ', 'AF', '2', 'EQ', 'DP', 'AP', 'BM', 'AF', 'BM', 'AF']",['15']
21,4,187,201,14,0,34,"['EY', '1', 'AA', '7', 'EQ', 'AP', 'BR', 'AF', 'BM', 'AF', '1', 'AD', 'FA', 'EU', '4', 'DL', 'AF', 'DS', 'BQ', 'AP', 'DS', 'BQ', 'ED', '15', 'ER', 'AF', '2', 'EQ', 'DP', 'AP', 'BM', 'AF', 'BM', 'AF']",['10']
22,2,192,338,146,0,34,"['EY', '1', 'AA', '7', 'EQ', 'AP', 'BR', 'AF', 'BM', 'AF', '1', 'AD', 'FA', 'EU', '4', 'DL', 'ED', '15', 'ER', 'AP', 'DS', 'BQ', 'AF', 'DS', 'BQ', 'AF', '2', 'EQ', 'DP', 'AP', 'BM', 'AF', 'BM', 'AF']",['7']
23,2,192,305,113,0,34,"['EY', '1', 'AA', '7', 'EQ', 'AP', 'BR', 'AF', 'BM', 'AF', '1', 'AD', 'FA', 'EU', '4', 'DL', 'ED', '15', 'ER', 'AP', 'DS', 'BQ', 'AF', 'DS', 'BQ', 'AF', '2', 'EQ', 'DP', 'AP', 'BM', 'AF', 'BM', 'AF']",['11']
24,2,192,201,9,0,34,"['EY', '1', 'AA', '7', 'EQ', 'AP', 'BR', 'AF', 'BM', 'AF', '1', 'AD', 'FA', 'EU', '4', 'DL', 'ED', '15', 'ER', 'AP', 'DS', 'BQ', 'AF', 'DS', 'BQ', 'AF', '2', 'EQ', 'DP', 'AP', 'BM', 'AF', 'BM', 'AF']",['19']
25,7,196,366,170,0,34,"['EY', '1', 'AA', '7', 'EQ', 'AP', 'BR', 'AF', 'BM', 'AF', '1', 'AD', 'FA', 'EU', '4', 'DL', 'ED', '15', 'ER', 'AP', 'DS', 'BQ', 'AF', 'DS', 'BQ', 'AF', '2', 'EQ', 'DP', 'AP', 'BM', 'AF', 'BM', 'AF']",['20']
26,5,201,224,23,0,34,"['EY', '1', 'AA', '7', 'EQ', 'AP', 'BR', 'AF', 'BM', 'AF', '1', 'AD', 'FA', 'EU', '4', 'DL', 'ED', '15', 'ER', 'AP', 'DS', 'BQ', 'AF', 'DS', 'BQ', 'AF', '2', 'EQ', 'DP', 'AP', 'BM', 'AF', 'BM', 'AF']",['12']
27,3,206,348,142,0,34,"['EY', '1', 'AA', '7', 'EQ', 'AP', 'BR', 'AF', 'BM', 'AF', '1', 'AD', 'FA', 'EU', '4', 'DL', 'ED', '15', 'ER', 'AP', 'DS', 'BQ', 'AF', 'DS', 'BQ', 'AF', '2', 'EQ', 'DP', 'AP', 'BM', 'AF', 'BM', 'AF']",['6']
28,3,206,249,43,0,34,"['EY', '1', 'AA', '7', 'EQ', 'AP', 'BR', 'AF', 'BM', 'AF', '1', 'AD', 'FA', 'EU', '4', 'DL', 'ED', '15', 'ER', 'AP', 'DS', 'BQ', 'AF', 'DS', 'BQ', 'AF', '2', 'EQ', 'DP', 'AP', 'BM', 'AF', 'BM', 'AF']",['8']
29,3,206,423,217,0,34,"['EY', '1', 'AA', '7', 'EQ', 'AP', 'BR', 'AF', 'BM', 'AF', '1', 'AD', 'FA', 'EU', '4', 'DL', 'ED', '15', 'ER', 'AP', 'DS', 'BQ', 'AF', 'DS', 'BQ', 'AF', '2', 'EQ', 'DP', 'AP', 'BM', 'AF', 'BM', 'AF']",['22']
30,8,210,253,43,0,34,"['EY', '1', 'AA', '7', 'EQ', 'AP', 'BR', 'AF', 'BM', 'AF', '1', 'AD', 'FA', 'EU', '4', 'DL', 'ED', '15', 'ER', 'AP', 'DS', 'BQ', 'AF', 'DS', 'BQ', 'AF', '2', 'EQ', 'DP', 'AP', 'BM', 'AF', 'BM', 'AF']",['25']
31,1,211,387,176,0,34,"['EY', '1', 'AA', '7', 'EQ', 'AP', 'BR', 'AF', 'BM', 'AF', '1', 'AD', 'FA', 'EU', '4', 'DL', 'ED', '15', 'ER', 'AP', 'DS', 'BQ', 'AF', 'DS', 'BQ', 'AF', '2', 'EQ', 'DP', 'AP', 'BM', 'AF', 'BM', 'AF']",['1']
32,6,215,276,61,0,34,"['EY', '1', 'AA', '7', 'EQ', 'AP', 'BR', 'AF', 'BM', 'AF', '1', 'AD', 'FA', 'EU', '4', 'DL', 'ED', '15', 'ER', 'AP', 'DS', 'BQ', 'AF', 'DS', 'BQ', 'AF', '2', 'EQ', 'DP', 'AP', 'BM', 'AF', 'BM', 'AF']",['26']
33,4,220,234,14,0,34,"['EY', '1', 'AA', '7', 'EQ', 'AP', 'BR', 'AF', 'BM', 'AF', '1', 'AD', 'FA', 'EU', '4', 'DL', 'ED', '15', 'ER', 'AP', 'DS', 'BQ', 'AF', 'DS', 'BQ', 'AF', '2', 'EQ', 'DP', 'AP', 'BM', 'AF', 'BM', 'AF']",['17']
34,4,220,239,19,0,34,"['EY', '1', 'AA', '7', 'EQ', 'AP', 'BR', 'AF', 'BM', 'AF', '1', 'AD', 'FA', 'EU', '4', 'DL', 'ED', '15', 'ER', 'AP', 'DS', 'BQ', 'AF', 'DS', 'BQ', 'AF', '2', 'EQ', 'DP', 'AP', 'BM', 'AF', 'BM', 'AF']",['29']
35,4,220,279,59,0,34,"['EY', '1', 'AA', '7', 'EQ', 'AP', 'BR', 'AF', 'BM', 'AF', '1', 'AD', 'FA', 'EU', '4', 'DL', 'ED', '15', 'ER', 'AP', 'DS', 'BQ', 'AF', 'DS', 'BQ', 'AF', '2', 'EQ', 'DP', 'AP', 'BM', 'AF', 'BM', 'AF']",['28']
36,4,220,234,14,0,34,"['EY', '1', 'AA', '7', 'EQ', 'AP', 'BR', 'AF', 'BM', 'AF', '1', 'AD', 'FA', 'EU', '4', 'DL', 'ED', '15', 'ER', 'AP', 'DS', 'BQ', 'AF', 'DS', 'BQ', 'AF', '2', 'EQ', 'DP', 'AP', 'BM', 'AF', 'BM', 'AF']",['27']
37,9,224,443,219,0,34,"['EY', '1', 'AA', '7', 'EQ', 'AP', 'BR', 'AF', 'BM', 'AF', '1', 'AD', 'FA', 'EU', '4', 'DL', 'ED', '15', 'ER', 'AP', 'DS', 'BQ', 'AF', 'DS', 'BQ', 'AF', '2', 'EQ', 'DP', 'AP', 'BM', 'AF', 'BM', 'AF']",['30']
38,2,225,234,9,0,34,"['EY', '1', 'AA', '7', 'EQ', 'AP', 'BR', 'AF', 'BM', 'AF', '1', 'AD', 'FA', 'EU', '4', 'DL', 'ED', '15', 'ER', 'AP', 'DS', 'BQ', 'AF', 'DS', 'BQ', 'AF', '2', 'EQ', 'DP', 'AP', 'BM', 'AF', 'BM', 'AF']",['7']
39,2,225,239,14,0,34,"['EY', '1', 'AA', '7', 'EQ', 'AP', 'BR', 'AF', 'BM', 'AF', '1', 'AD', 'FA', 'EU', '4', 'DL', 'ED', '15', 'ER', 'AP', 'DS', 'BQ', 'AF', 'DS', 'BQ', 'AF', '2', 'EQ', 'DP', 'AP', 'BM', 'AF', 'BM', 'AF']",['11']
40,2,225,239,14,0,34,"['EY', '1', 'AA', '7', 'EQ', 'AP', 'BR', 'AF', 'BM', 'AF', '1', 'AD', 'FA', 'EU', '4', 'DL', 'ED', '15', 'ER', 'AP', 'DS', 'BQ', 'AF', 'DS', 'BQ', 'AF', '2', 'EQ', 'DP', 'AP', 'BM', 'AF', 'BM', 'AF']",['19']
41,2,225,423,198,0,34,"['EY', '1', 'AA', '7', 'EQ', 'AP', 'BR', 'AF', 'BM', 'AF', '1', 'AD', 'FA', 'EU', '4', 'DL', 'ED', '15', 'ER', 'AP', 'DS', 'BQ', 'AF', 'DS', 'BQ', 'AF', '2', 'EQ', 'DP', 'AP', 'BM', 'AF', 'BM', 'AF']",['31']
42,7,229,243,14,0,34,"['EY', '1', 'AA', '7', 'EQ', 'AP', 'BR', 'AF', 'BM', 'AF', '1', 'AD', 'FA', 'EU', '4', 'DL', 'ED', '15', 'ER', 'AP', 'DS', 'BQ', 'AF', 'DS', 'BQ', 'AF', '2', 'EQ', 'DP', 'AP', 'BM', 'AF', 'BM', 'AF']",['20']
43,7,229,238,9,0,34,"['EY', '1', 'AA', '7', 'EQ', 'AP', 'BR', 'AF', 'BM', 'AF', '1', 'AD', 'FA', 'EU', '4', 'DL', 'ED', '15', 'ER', 'AP', 'DS', 'BQ', 'AF', 'DS', 'BQ', 'AF', '2', 'EQ', 'DP', 'AP', 'BM', 'AF', 'BM', 'AF']",['32']
44,5,234,419,185,0,34,"['EY', '1', 'AA', '7', 'EQ', 'AP', 'BR', 'AF', 'BM', 'AF', '1', 'AD', 'FA', 'EU', '4', 'DL', 'ED', '15', 'ER', 'AP', 'DS', 'BQ', 'AF', 'DS', 'BQ', 'AF', '2', 'EQ', 'DP', 'AP', 'BM', 'AF', 'BM', 'AF']",['34']
45,10,238,309,71,0,34,"['EY', '1', 'AA', '7', 'EQ', 'AP', 'BR', 'AF', 'BM', 'AF', '1', 'AD', 'FA', 'EU', '4', 'DL', 'ED', '15', 'ER', 'AP', 'DS', 'BQ', 'AF', 'DS', 'BQ', 'AF', '2', 'EQ', 'DP', 'AP', 'BM', 'AF', 'BM', 'AF']",['37']
46,3,239,315,76,0,34,"['EY', '1', 'AA', '7', 'EQ', 'AP', 'BR', 'AF', 'BM', 'AF', '1', 'AD', 'FA', 'EU', '4', 'DL', 'ED', '15', 'ER', 'AP', 'DS', 'BQ', 'AF', 'DS', 'BQ', 'AF', '2', 'EQ', 'DP', 'AP', 'BM', 'AF', 'BM', 'AF']",['6']
47,3,239,353,114,0,12,"['EY', '1', 'AA', '7', 'EQ', 'AP', 'BR', 'AF', 'BM', 'AF', '1', 'AD']",['8']
48,3,239,253,14,0,34,"['EY', '1', 'AA', '7', 'EQ', 'AP', 'BR', 'AF', 'BM', 'AF', '1', 'AD', 'FA', 'EU', '4', 'DL', 'ED', '15', 'ER', 'AP', 'DS', 'BQ', 'AF', 'DS', 'BQ', 'AF', '2', 'EQ', 'DP', 'AP', 'BM', 'AF', 'BM', 'AF']",['23']
49,3,239,333,94,0,34,"['EY', '1', 'AA', '7', 'EQ', 'AP', 'BR', 'AF', 'BM', 'AF', '1', 'AD', 'FA', 'EU', '4', 'DL', 'ED', '15', 'ER', 'AP', 'DS', 'BQ', 'AF', 'DS', 'BQ', 'AF', '2', 'EQ', 'DP', 'AP', 'BM', 'AF', 'BM', 'AF']",['22']
50,3,239,282,43,0,34,"['EY', '1', 'AA', '7', 'EQ', 'AP', 'BR', 'AF', 'BM', 'AF', '1', 'AD', 'FA', 'EU', '4', 'DL', 'ED', '15', 'ER', 'AP', 'DS', 'BQ', 'AF', 'DS', 'BQ', 'AF', '2', 'EQ', 'DP', 'AP', 'BM', 'AF', 'BM', 'AF']",['41']
51,8,243,257,14,0,34,"['EY', '1', 'AA', '7', 'EQ', 'AP', 'BR', 'AF', 'BM', 'AF', '1', 'AD', 'FA', 'EU', '4', 'DL', 'ED', '15', 'ER', 'AP', 'DS', 'BQ', 'AF', 'DS', 'BQ', 'AF', '2', 'EQ', 'DP', 'AP', 'BM', 'AF', 'BM', 'AF']",['25']
52,1,244,320,76,0,34,"['EY', '1', 'AA', '7', 'EQ', 'AP', 'BR', 'AF', 'BM', 'AF', '1', 'AD', 'FA', 'EU', '4', 'DL', 'ED', '15', 'ER', 'AP', 'DS', 'BQ', 'AF', 'DS', 'BQ', 'AF', '2', 'EQ', 'DP', 'AP', 'BM', 'AF', 'BM', 'AF']",['1']
53,6,248,262,14,0,34,"['EY', '1', 'AA', '7', 'EQ', 'AP', 'BR', 'AF', 'BM', 'AF', '1', 'AD', 'FA', 'EU', '4', 'DL', 'ED', '15', 'ER', 'AP', 'DS', 'BQ', 'AF', 'DS', 'BQ', 'AF', '2', 'EQ', 'DP', 'AP', 'BM', 'AF', 'BM', 'AF']",['44']
54,11,252,579,327,0,34,"['EY', '1', 'AA', '7', 'EQ', 'AP', 'BR', 'AF', 'BM', 'AF', '1', 'AD', 'FA', 'EU', '4', 'DL', 'ED', '15', 'ER', 'AP', 'DS', 'BQ', 'AF', 'DS', 'BQ', 'AF', '2', 'EQ', 'DP', 'AP', 'BM', 'AF', 'BM', 'AF']",['45']
55,4,253,267,14,0,34,"['EY', '1', 'AA', '7', 'EQ', 'AP', 'BR', 'AF', 'BM', 'AF', '1', 'AD', 'FA', 'EU', '4', 'DL', 'ED', '15', 'ER', 'AP', 'DS', 'BQ', 'AF', 'DS', 'BQ', 'AF', '2', 'EQ', 'DP', 'AP', 'BM', 'AF', 'BM', 'AF']",['17']
56,4,253,267,14,0,34,"['EY', '1', 'AA', '7', 'EQ', 'AP', 'BR', 'AF', 'BM', 'AF', '1', 'AD', 'FA', 'EU', '4', 'DL', 'ED', '15', 'ER', 'AP', 'DS', 'BQ', 'AF', 'DS', 'BQ', 'AF', '2', 'EQ', 'DP', 'AP', 'BM', 'AF', 'BM', 'AF']",['29']
57,4,253,489,236,0,34,"['EY', '1', 'AA', '7', 'EQ', 'AP', 'BR', 'AF', 'BM', 'AF', '1', 'AD', 'FA', 'EU', '4', 'DL', 'ED', '15', 'ER', 'AP', 'DS', 'BQ', 'AF', 'DS', 'BQ', 'AF', '2', 'EQ', 'DP', 'AP', 'BM', 'AF', 'BM', 'AF']",['27']
58,4,253,295,42,0,34,"['EY', '1', 'AA', '7', 'EQ', 'AP', 'BR', 'AF', 'BM', 'AF', '1', 'AD', 'FA', 'EU', '4', 'DL', 'ED', '15', 'ER', 'AP', 'DS', 'BQ', 'AF', 'DS', 'BQ', 'AF', '2', 'EQ', 'DP', 'AP', 'BM', 'AF', 'BM', 'AF']",['50']
59,4,253,267,14,0,34,"['EY', '1', 'AA', '7', 'EQ', 'AP', 'BR', 'AF', 'BM', 'AF', '1', 'AD', 'FA', 'EU', '4', 'DL', 'ED', '15', 'ER', 'AP', 'DS', 'BQ', 'AF', 'DS', 'BQ', 'AF', '2', 'EQ', 'DP', 'AP', 'BM', 'AF', 'BM', 'AF']",['49']
60,4,253,282,29,0,12,"['EY', '1', 'AA', '7', 'EQ', 'AP', 'BR', 'AF', 'BM', 'AF', '1', 'AD']",['46']
61,2,258,319,61,0,34,"['EY', '1', 'AA', '7', 'EQ', 'AP', 'BR', 'AF', 'BM', 'AF', '1', 'AD', 'FA', 'EU', '4', 'DL', 'ED', '15', 'ER', 'AP', 'DS', 'BQ', 'AF', 'DS', 'BQ', 'AF', '2', 'EQ', 'DP', 'AP', 'BM', 'AF', 'BM', 'AF']",['11']
62,2,258,272,14,0,34,"['EY', '1', 'AA', '7', 'EQ', 'AP', 'BR', 'AF', 'BM', 'AF', '1', 'AD', 'FA', 'EU', '4', 'DL', 'ED', '15', 'ER', 'AP', 'DS', 'BQ', 'AF', 'DS', 'BQ', 'AF', '2', 'EQ', 'DP', 'AP', 'BM', 'AF', 'BM', 'AF']",['19']
63,2,258,272,14,0,34,"['EY', '1', 'AA', '7', 'EQ', 'AP', 'BR', 'AF', 'BM', 'AF', '1', 'AD', 'FA', 'EU', '4', 'DL', 'ED', '15', 'ER', 'AP', 'DS', 'BQ', 'AF', 'DS', 'BQ', 'AF', '2', 'EQ', 'DP', 'AP', 'BM', 'AF', 'BM', 'AF']",['31']
64,2,258,526,268,0,34,"['EY', '1', 'AA', '7', 'EQ', 'AP', 'BR', 'AF', 'BM', 'AF', '1', 'AD', 'FA', 'EU', '4', 'DL', 'ED', '15', 'ER', 'AP', 'DS', 'BQ', 'AF', 'DS', 'BQ', 'AF', '2', 'EQ', 'DP', 'AP', 'BM', 'AF', 'BM', 'AF']",['52']
65,7,262,324,62,0,34,"['EY', '1', 'AA', '7', 'EQ', 'AP', 'BR', 'AF', 'BM', 'AF', '1', 'AD', 'FA', 'EU', '4', 'DL', 'ED', '15', 'ER', 'AP', 'DS', 'BQ', 'AF', 'DS', 'BQ', 'AF', '2', 'EQ', 'DP', 'AP', 'BM', 'AF', 'BM', 'AF']",['20']
66,7,262,328,66,0,34,"['EY', '1', 'AA', '7', 'EQ', 'AP', 'BR', 'AF', 'BM', 'AF', '1', 'AD', 'FA', 'EU', '4', 'DL', 'ED', '15', 'ER', 'AP', 'DS', 'BQ', 'AF', 'DS', 'BQ', 'AF', '2', 'EQ', 'DP', 'AP', 'BM', 'AF', 'BM', 'AF']",['32']
67,12,266,418,152,0,34,"['EY', '1', 'AA', '7', 'EQ', 'AP', 'BR', 'AF', 'BM', 'AF', '1', 'AD', 'FA', 'EU', '4', 'DL', 'ED', '15', 'ER', 'AP', 'DS', 'BQ', 'AF', 'DS', 'BQ', 'AF', '2', 'EQ', 'DP', 'AP', 'BM', 'AF', 'BM', 'AF']",['54']
68,5,267,268,1,0,34,"['EY', '1', 'AA', '7', 'EQ', 'AP', 'BR', 'AF', 'BM', 'AF', '1', 'AD', 'FA', 'EU', '4', 'DL', 'ED', '15', 'ER', 'AP', 'DS', 'BQ', 'AF', 'DS', 'BQ', 'AF', '2', 'EQ', 'DP', 'AP', 'BM', 'AF', 'BM', 'AF']",['35']
69,5,267,281,14,0,34,"['EY', '1', 'AA', '7', 'EQ', 'AP', 'BR', 'AF', 'BM', 'AF', '1', 'AD', 'FA', 'EU', '4', 'DL', 'ED', '15', 'ER', 'AP', 'DS', 'BQ', 'AF', 'DS', 'BQ', 'AF', '2', 'EQ', 'DP', 'AP', 'BM', 'AF', 'BM', 'AF']",['57']
70,10,271,290,19,0,34,"['EY', '1', 'AA', '7', 'EQ', 'AP', 'BR', 'AF', 'BM', 'AF', '1', 'AD', 'FA', 'EU', '4', 'DL', 'ED', '15', 'ER', 'AP', 'DS', 'BQ', 'AF', 'DS', 'BQ', 'AF', '2', 'EQ', 'DP', 'AP', 'BM', 'AF', 'BM', 'AF']",['37']
71,3,272,452,180,0,34,"['EY', '1', 'AA', '7', 'EQ', 'AP', 'BR', 'AF', 'BM', 'AF', '1', 'AD', 'FA', 'EU', '4', 'DL', 'ED', '15', 'ER', 'AP', 'DS', 'BQ', 'AF', 'DS', 'BQ', 'AF', '2', 'EQ', 'DP', 'AP', 'BM', 'AF', 'BM', 'AF']",['6']
72,3,272,442,170,0,34,"['EY', '1', 'AA', '7', 'EQ', 'AP', 'BR', 'AF', 'BM', 'AF', '1', 'AD', 'FA', 'EU', '4', 'DL', 'ED', '15', 'ER', 'AP', 'DS', 'BQ', 'AF', 'DS', 'BQ', 'AF', '2', 'EQ', 'DP', 'AP', 'BM', 'AF', 'BM', 'AF']",['23']
73,3,272,286,14,0,34,"['EY', '1', 'AA', '7', 'EQ', 'AP', 'BR', 'AF', 'BM', 'AF', '1', 'AD', 'FA', 'EU', '4', 'DL', 'ED', '15', 'ER', 'AP', 'DS', 'BQ', 'AF', 'DS', 'BQ', 'AF', '2', 'EQ', 'DP', 'AP', 'BM', 'AF', 'BM', 'AF']",['22']
74,3,272,286,14,0,34,"['EY', '1', 'AA', '7', 'EQ', 'AP', 'BR', 'AF', 'BM', 'AF', '1', 'AD', 'FA', 'EU', '4', 'DL', 'ED', '15', 'ER', 'AP', 'DS', 'BQ', 'AF', 'DS', 'BQ', 'AF', '2', 'EQ', 'DP', 'AP', 'BM', 'AF', 'BM', 'AF']",['41']
75,3,272,348,76,0,34,"['EY', '1', 'AA', '7', 'EQ', 'AP', 'BR', 'AF', 'BM', 'AF', '1', 'AD', 'FA', 'EU', '4', 'DL', 'ED', '15', 'ER', 'AP', 'DS', 'BQ', 'AF', 'DS', 'BQ', 'AF', '2', 'EQ', 'DP', 'AP', 'BM', 'AF', 'BM', 'AF']",['64']
76,8,276,285,9,0,38,"['EY', '1', 'AA', '7', 'EQ', 'AP', 'BR', 'AF', 'BM', 'AF', '1', 'AD', '-73', 'EE', 'BD', 'AP', 'FA', 'EU', '4', 'DL', 'ED', '15', 'ER', 'AP', 'DS', 'BQ', 'AF', 'DS', 'BQ', 'AF', '2', 'EQ', 'DP', 'AP', 'BM', 'AF', 'BM', 'AF']",['25']
77,8,276,319,43,0,34,"['EY', '1', 'AA', '7', 'EQ', 'AP', 'BR', 'AF', 'BM', 'AF', '1', 'AD', 'FA', 'EU', '4', 'DL', 'ED', '15', 'ER', 'AP', 'DS', 'BQ', 'AF', 'DS', 'BQ', 'AF', '2', 'EQ', 'DP', 'AP', 'BM', 'AF', 'BM', 'AF']",['66']
78,8,276,290,14,0,34,"['EY', '1', 'AA', '7', 'EQ', 'AP', 'BR', 'AF', 'BM', 'AF', '1', 'AD', 'FA', 'EU', '4', 'DL', 'ED', '15', 'ER', 'AP', 'DS', 'BQ', 'AF', 'DS', 'BQ', 'AF', '2', 'EQ', 'DP', 'AP', 'BM', 'AF', 'BM', 'AF']",['65']
79,13,280,448,168,0,34,"['EY', '1', 'AA', '7', 'EQ', 'AP', 'BR', 'AF', 'BM', 'AF', '1', 'AD', 'FA', 'EU', '4', 'DL', 'ED', '15', 'ER', 'AP', 'DS', 'BQ', 'AF', 'DS', 'BQ', 'AF', '2', 'EQ', 'DP', 'AP', 'BM', 'AF', 'BM', 'AF']",['67']
80,6,281,323,42,0,34,"['EY', '1', 'AA', '7', 'EQ', 'AP', 'BR', 'AF', 'BM', 'AF', '1', 'AD', 'FA', 'EU', '4', 'DL', 'ED', '15', 'ER', 'AP', 'DS', 'BQ', 'AF', 'DS', 'BQ', 'AF', '2', 'EQ', 'DP', 'AP', 'BM', 'AF', 'BM', 'AF']",['44']
81,11,285,299,14,0,34,"['EY', '1', 'AA', '7', 'EQ', 'AP', 'BR', 'AF', 'BM', 'AF', '1', 'AD', 'FA', 'EU', '4', 'DL', 'ED', '15', 'ER', 'AP', 'DS', 'BQ', 'AF', 'DS', 'BQ', 'AF', '2', 'EQ', 'DP', 'AP', 'BM', 'AF', 'BM', 'AF']",['45']
82,11,285,304,19,0,34,"['EY', '1', 'AA', '7', 'EQ', 'AP', 'BR', 'AF', 'BM', 'AF', '1', 'AD', 'FA', 'EU', '4', 'DL', 'ED', '15', 'ER', 'AP', 'DS', 'BQ', 'AF', 'DS', 'BQ', 'AF', '2', 'EQ', 'DP', 'AP', 'BM', 'AF', 'BM', 'AF']",['70']
83,4,286,300,14,0,34,"['EY', '1', 'AA', '7', 'EQ', 'AP', 'BR', 'AF', 'BM', 'AF', '1', 'AD', 'FA', 'EU', '4', 'DL', 'ED', '15', 'ER', 'AP', 'DS', 'BQ', 'AF', 'DS', 'BQ', 'AF', '2', 'EQ', 'DP', 'AP', 'BM', 'AF', 'BM', 'AF']",['17']
84,4,286,367,81,0,34,"['EY', '1', 'AA', '7', 'EQ', 'AP', 'BR', 'AF', 'BM', 'AF', '1', 'AD', 'FA', 'EU', '4', 'DL', 'ED', '15', 'ER', 'AP', 'DS', 'BQ', 'AF', 'DS', 'BQ', 'AF', '2', 'EQ', 'DP', 'AP', 'BM', 'AF', 'BM', 'AF']",['29']
85,4,286,447,161,0,34,"['EY', '1', 'AA', 'AF', '1', 'AD', 'BR', 'AF', 'BM', '7', 'EQ', 'AP', 'FA', 'EU', '4', 'DL', 'ED', '15', 'ER', 'AP', 'DS', 'BQ', 'AF', 'DS', 'BQ', 'AF', '2', 'EQ', 'DP', 'AP', 'BM', 'AF', 'BM', 'AF']",['27']
86,4,286,300,14,0,34,"['EY', '1', 'AA', '7', 'EQ', 'AP', 'BR', 'AF', 'BM', 'AF', '1', 'AD', 'FA', 'EU', '4', 'DL', 'ED', '15', 'ER', 'AP', 'DS', 'BQ', 'AF', 'DS', 'BQ', 'AF', '2', 'EQ', 'DP', 'AP', 'BM', 'AF', 'BM', 'AF']",['49']
87,4,286,395,109,0,34,"['EY', '1', 'AA', '7', 'EQ', 'AP', 'BR', 'AF', 'BM', 'AF', '1', 'AD', 'FA', 'EU', '4', 'DL', 'ED', '15', 'ER', 'AP', 'DS', 'BQ', 'AF', 'DS', 'BQ', 'AF', '2', 'EQ', 'DP', 'AP', 'BM', 'AF', 'BM', 'AF']",['46']
88,4,286,305,19,0,34,"['EY', '1', 'AA', '7', 'EQ', 'AP', 'BR', 'AF', 'BM', 'AF', '1', 'AD', 'FA', 'EU', '4', 'DL', 'ED', '15', 'ER', 'AP', 'DS', 'BQ', 'AF', 'DS', 'BQ', 'AF', '2', 'EQ', 'DP', 'AP', 'BM', 'AF', 'BM', 'AF']",['75']
89,4,286,348,62,0,30,"['EY', '1', 'AA', '7', 'EQ', 'AP', 'BR', 'AF', 'BM', 'AF', '1', 'AD', 'FA', 'EU', '4', 'DL', 'ED', 'BQ', 'AF', 'DS', 'BQ', 'AF', '2', 'EQ', 'DP', 'AP', 'BM', 'AF', 'BM', 'AF']",['72']
90,4,286,300,14,0,34,"['EY', '1', 'AA', '7', 'EQ', 'AP', 'BR', 'AF', 'BM', 'AF', '1', 'AD', 'FA', 'EU', '4', 'DL', 'ED', '15', 'ER', 'AP', 'DS', 'BQ', 'AF', 'DS', 'BQ', 'AF', '2', 'EQ', 'DP', 'AP', 'BM', 'AF', 'BM', 'AF']",['71']
91,9,290,333,43,0,34,"['EY', '1', 'AA', '7', 'EQ', 'AP', 'BR', 'AF', 'BM', 'AF', '1', 'AD', 'FA', 'EU', '4', 'DL', 'ED', '15', 'ER', 'AP', 'DS', 'BQ', 'AF', 'DS', 'BQ', 'AF', '2', 'EQ', 'DP', 'AP', 'BM', 'AF', 'BM', 'AF']",['77']
92,2,291,461,170,0,34,"['EY', '1', 'AA', '7', 'EQ', 'AP', 'BR', 'AF', 'BM', 'AF', '1', 'AD', 'FA', 'EU', '4', 'DL', 'ED', '15', 'ER', 'AP', 'DS', 'BQ', 'AF', 'DS', 'BQ', 'AF', '2', 'EQ', 'DP', 'AP', 'BM', 'AF', 'BM', 'AF']",['11']
93,2,291,508,217,0,34,"['EY', '1', 'AA', '7', 'EQ', 'AP', 'BR', 'AF', 'BM', 'AF', '1', 'AD', 'FA', 'EU', '4', 'DL', 'ED', '15', 'ER', 'AP', 'DS', 'BQ', 'AF', 'DS', 'BQ', 'AF', '2', 'EQ', 'DP', 'AP', 'BM', 'AF', 'BM', 'AF']",['19']
94,2,291,305,14,0,34,"['EY', '1', 'AA', '7', 'EQ', 'AP', 'BR', 'AF', 'BM', 'AF', '1', 'AD', 'FA', 'EU', '4', 'DL', 'ED', '15', 'ER', 'AP', 'DS', 'BQ', 'AF', 'DS', 'BQ', 'AF', '2', 'EQ', 'DP', 'AP', 'BM', 'AF', 'BM', 'AF']",['31']
95,2,291,385,94,0,34,"['EY', '1', 'AA', '7', 'EQ', 'AP', 'BR', 'AF', 'BM', 'AF', '1', 'AD', 'FA', 'EU', '4', 'DL', 'ED', '15', 'ER', 'AP', 'DS', 'BQ', 'AF', 'DS', 'BQ', 'AF', '2', 'EQ', 'DP', 'AP', 'BM', 'AF', 'BM', 'AF']",['52']
96,7,295,418,123,0,34,"['EY', '1', 'AA', '7', 'EQ', 'AP', 'BR', 'AF', 'BM', 'AF', '1', 'AD', 'FA', 'EU', '4', 'DL', 'ED', '15', 'ER', 'AP', 'DS', 'BQ', 'AF', 'DS', 'BQ', 'AF', '2', 'EQ', 'DP', 'AP', 'BM', 'AF', 'BM', 'AF']",['20']
97,7,295,334,39,0,34,"['EY', '1', 'AA', '7', 'EQ', 'AP', 'BR', 'AF', 'BM', 'AF', '1', 'AD', 'FA', 'EU', '4', 'DL', 'ED', '15', 'ER', 'AP', 'DS', 'BQ', 'AF', 'DS', 'BQ', 'AF', '2', 'EQ', 'DP', 'AP', 'BM', 'AF', 'BM', 'AF']",['80']
98,12,299,353,54,0,34,"['EY', '1', 'AA', '7', 'EQ', 'AP', 'BR', 'AF', 'BM', 'AF', '1', 'AD', 'FA', 'EU', '4', 'DL', 'ED', '15', 'ER', 'AP', 'DS', 'BQ', 'AF', 'DS', 'BQ', 'AF', '2', 'EQ', 'DP', 'AP', 'BM', 'AF', 'BM', 'AF']",['54']
99,12,299,438,139,0,34,"['EY', '1', 'AA', '7', 'EQ', 'AP', 'BR', 'AF', 'BM', 'AF', '1', 'AD', 'FA', 'EU', '4', 'DL', 'ED', '15', 'ER', 'AP', 'DS', 'BQ', 'AF', 'DS', 'BQ', 'AF', '2', 'EQ', 'DP', 'AP', 'BM', 'AF', 'BM', 'AF']",['82']
100,5,300,475,175,0,34,"['EY', '1', 'AA', '7', 'EQ', 'AP', 'BR', 'AF', 'BM', 'AF', '1', 'AD', 'FA', 'EU', '4', 'DL', 'ED', '15', 'ER', 'AP', 'DS', 'BQ', 'AF', 'DS', 'BQ', 'AF', '2', 'EQ', 'DP', 'AP', 'BM', 'AF', 'BM', 'AF']",['57']
101,5,300,329,29,0,34,"['EY', '1', 'AA', '7', 'EQ', 'AP', 'BR', 'AF', 'BM', 'AF', '1', 'AD', 'FA', 'EU', '4', 'DL', 'ED', '15', 'ER', 'AP', 'DS', 'BQ', 'AF', 'DS', 'BQ', 'AF', '2', 'EQ', 'DP', 'AP', 'BM', 'AF', 'BM', 'AF']",['87']
102,5,300,472,172,0,34,"['EY', '1', 'AA', 'AF', '1', 'AD', 'BR', 'AF', 'BM', '7', 'EQ', 'AP', 'FA', 'EU', '4', 'DL', 'ED', '15', 'ER', 'AP', 'DS', 'BQ', 'AF', 'DS', 'BQ', 'AF', '2', 'EQ', 'DP', 'AP', 'BM', 'AF', 'BM', 'AF']",['85']
103,10,304,318,14,0,34,"['EY', '1', 'AA', '7', 'EQ', 'AP', 'BR', 'AF', 'BM', 'AF', '1', 'AD', 'FA', 'EU', '4', 'DL', 'ED', '15', 'ER', 'AP', 'DS', 'BQ', 'AF', 'DS', 'BQ', 'AF', '2', 'EQ', 'DP', 'AP', 'BM', 'AF', 'BM', 'AF']",['37']
104,10,304,347,43,0,34,"['EY', '1', 'AA', '7', 'EQ', 'AP', 'BR', 'AF', 'BM', 'AF', '1', 'AD', 'FA', 'EU', '4', 'DL', 'ED', '15', 'ER', 'AP', 'DS', 'BQ', 'AF', 'DS', 'BQ', 'AF', '2', 'EQ', 'DP', 'AP', 'BM', 'AF', 'BM', 'AF']",['91']
105,3,305,442,137,0,12,"['EY', '1', 'AA', '7', 'EQ', 'AP', 'BR', 'AF', 'BM', 'AF', '1', 'AD']",['22']
106,3,305,319,14,0,32,"['EY', '1', 'AA', '7', 'EQ', 'AP', 'BR', 'AF', 'BM', 'DC', '1', 'AD', 'FA', 'EU', '4', 'DL', 'ED', '15', 'ER', 'AP', 'DS', 'BQ', 'AF', 'DS', 'BQ', 'AF', '2', 'EQ', 'DP', 'AF', 'BM', 'AF']",['41']
107,3,305,371,66,0,34,"['EY', '1', 'AA', '7', 'EQ', 'AP', 'BR', 'AF', 'BM', 'AF', '1', 'AD', 'FA', 'EU', '4', 'DL', 'ED', '15', 'ER', 'AP', 'DS', 'BQ', 'AF', 'DS', 'BQ', 'AF', '2', 'EQ', 'DP', 'AP', 'BM', 'AF', 'BM', 'AF']",['64']
108,3,305,328,23,0,34,"['EY', '1', 'AA', '7', 'EQ', 'AP', 'BR', 'AF', 'BM', 'AF', '1', 'AD', 'FA', 'EU', '4', 'DL', 'ED', '15', 'ER', 'AP', 'DS', 'BQ', 'AF', 'DS', 'BQ', 'AF', '2', 'EQ', 'DP', 'AP', 'BM', 'AF', 'BM', 'AF']",['61']
109,3,305,352,47,0,34,"['EY', '1', 'AA', '7', 'EQ', 'AP', 'BR', 'AF', 'BM', 'AF', '1', 'AD', 'FA', 'EU', '4', 'DL', 'ED', '15', 'ER', 'AP', 'DS', 'BQ', 'AF', 'DS', 'BQ', 'AF', '2', 'EQ', 'DP', 'AP', 'BM', 'AF', 'BM', 'AF']",['95']
110,3,305,353,48,0,34,"['EY', '1', 'AA', '7', 'EQ', 'AP', 'BR', 'AF', 'BM', 'AF', '1', 'AD', 'FA', 'EU', '4', 'DL', 'ED', '15', 'ER', 'AP', 'DS', 'BQ', 'AF', 'DS', 'BQ', 'AF', '2', 'EQ', 'DP', 'AP', 'BM', 'AF', 'BM', 'AF']",['93']
111,8,306,333,27,40,34,"['EY', '1', 'AA', '7', 'EQ', 'AP', 'BR', 'BM', 'BM', 'AF', '1', 'AD', 'FA', 'EU', '4', 'DL', 'ED', '15', 'ER', 'AP', 'DS', 'BQ', 'AF', 'DS', 'BQ', 'AF', '2', 'EQ', 'DP', 'AP', 'AF', 'AF', 'BM', 'AF']","['65', '25']"
112,8,309,360,51,0,36,"['EY', '1', 'AA', '7', 'EQ', 'AP', 'BR', 'AF', 'BM', '73', '27', 'AF', '1', 'AD', 'FA', 'EU', '4', 'DL', 'ED', '15', 'ER', 'AP', 'DS', 'BQ', 'AF', 'DS', 'BQ', 'AF', '2', 'EQ', 'DP', 'AP', 'BM', 'AF', 'BM', 'AF']",['66']
113,13,313,327,14,0,34,"['EY', '1', 'AA', '7', 'EQ', 'AP', 'BR', 'AF', 'BM', 'AF', '1', 'AD', 'FA', 'EU', '4', 'DL', 'ED', '15', 'ER', 'AP', 'DS', 'BQ', 'AF', 'DS', 'BQ', 'AF', '2', 'EQ', 'DP', 'AP', 'BM', 'AF', 'BM', 'AF']",['67']
114,13,313,337,24,0,34,"['EY', '1', 'AA', '7', 'EQ', 'AP', 'BR', 'AF', 'BM', 'AF', '1', 'AD', 'FA', 'EU', '4', 'DL', 'ED', '15', 'ER', 'AP', 'DS', 'BQ', 'AF', 'DS', 'BQ', 'AF', '2', 'EQ', 'DP', 'AP', 'BM', 'AF', 'BM', 'AF']",['99']
115,6,314,361,47,0,34,"['EY', '1', 'AA', '7', 'EQ', 'AP', 'BR', 'AF', 'BM', 'AF', '1', 'AD', 'FA', 'EU', '4', 'DL', 'ED', '15', 'ER', 'AP', 'DS', 'BQ', 'AF', 'DS', 'BQ', 'AF', '2', 'EQ', 'DP', 'AP', 'BM', 'AF', 'BM', 'AF']",['44']
116,6,314,911,597,0,34,"['EY', '1', 'AA', 'AF', '1', 'AD', 'BR', 'AF', 'BM', '7', 'EQ', 'AP', 'FA', 'EU', '4', 'DL', 'ED', '15', 'ER', 'AP', 'DS', 'BQ', 'AF', 'DS', 'BQ', 'AF', '2', 'EQ', 'DP', 'AP', 'BM', 'AF', 'BM', 'AF']",['102']
117,6,314,328,14,0,34,"['EY', '1', 'AA', '7', 'EQ', 'AP', 'BR', 'AF', 'BM', 'AF', '1', 'AD', 'FA', 'EU', '4', 'DL', 'ED', '15', 'ER', 'AP', 'DS', 'BQ', 'AF', 'DS', 'BQ', 'AF', '2', 'EQ', 'DP', 'AP', 'BM', 'AF', 'BM', 'AF']",['101']
118,6,314,362,48,0,34,"['EY', '1', 'AA', '7', 'EQ', 'AP', 'BR', 'AF', 'BM', 'AF', '1', 'AD', 'FA', 'EU', '4', 'DL', 'ED', '15', 'ER', 'AP', 'DS', 'BQ', 'AF', 'DS', 'BQ', 'AF', '2', 'EQ', 'DP', 'AP', 'BM', 'AF', 'BM', 'AF']",['100']
119,11,318,418,100,0,34,"['EY', '1', 'AA', '7', 'EQ', 'AP', 'BR', 'AF', 'BM', 'AF', '1', 'AD', 'FA', 'EU', '4', 'DL', 'ED', '15', 'ER', 'AP', 'DS', 'BQ', 'AF', 'DS', 'BQ', 'AF', '2', 'EQ', 'DP', 'AP', 'BM', 'AF', 'BM', 'AF']",['104']
120,4,319,344,25,0,34,"['EY', '1', 'AA', '7', 'EQ', 'AP', 'BR', 'AF', 'BM', 'AF', '1', 'AD', 'FA', 'EU', '4', 'DL', 'ED', '15', 'ER', 'AP', 'DS', 'BQ', 'AF', 'DS', 'BQ', 'AF', '2', 'EQ', 'DP', 'AP', 'BM', 'AF', 'BM', 'AF']",['29']
121,4,319,502,183,0,34,"['EY', '1', 'AA', '7', 'EQ', 'AP', 'BR', 'AF', 'BM', 'AF', '1', 'AD', 'FA', 'EU', '4', 'DL', 'ED', '15', 'ER', 'AP', 'DS', 'BQ', 'AF', 'DS', 'BQ', 'AF', '2', 'EQ', 'DP', 'AP', 'BM', 'AF', 'BM', 'AF']",['27']
122,4,319,389,70,0,45,"['EY', '1', 'AA', '7', 'EQ', 'AP', 'BR', 'AF', 'BM', 'AF', '1', 'AD', 'FA', 'AA', '7', 'EQ', 'AP', 'BR', 'AF', 'BM', 'AF', '1', 'AD', 'FB', 'EU', '4', 'DL', 'ED', '15', 'ER', 'AP', 'DS', 'BQ', 'AF', 'DS', 'BQ', 'AF', '2', 'EQ', 'DP', 'AP', 'BM', 'AF', 'BM', 'AF']",['49']
123,4,319,679,360,0,34,"['EY', '1', 'AA', '7', 'EQ', 'AP', 'BR', 'AF', 'BM', 'AF', '1', 'AD', 'FA', 'EU', '4', 'DL', 'ED', '15', 'ER', 'AP', 'DS', 'BQ', 'AF', 'DS', 'BQ', 'AF', '2', 'EQ', 'DP', 'AP', 'BM', 'AF', 'BM', 'AF']",['75']
124,4,319,550,231,0,34,"['EY', '1', 'AA', '7', 'EQ', 'AP', 'BR', 'AF', 'BM', 'AF', '1', 'AD', 'FA', 'EU', '4', 'DL', 'ED', '15', 'ER', 'AP', 'DS', 'BQ', 'AF', 'DS', 'BQ', 'AF', '2', 'EQ', 'DP', 'AP', 'BM', 'AF', 'BM', 'AF']",['72']
125,4,319,380,61,0,34,"['EY', '1', 'AA', '7', 'EQ', 'AP', 'BR', 'AF', 'BM', 'AF', '1', 'AD', 'FA', 'EU', '4', 'DL', 'ED', '15', 'ER', 'AP', 'DS', 'BQ', 'AF', 'DS', 'BQ', 'AF', '2', 'EQ', 'DP', 'AP', 'BM', 'AF', 'BM', 'AF']",['71']
126,4,319,333,14,0,34,"['EY', '1', 'AA', '7', 'EQ', 'AP', 'BR', 'AF', 'BM', 'AF', '1', 'AD', 'FA', 'EU', '4', 'DL', 'ED', '15', 'ER', 'AP', 'DS', 'BQ', 'AF', 'DS', 'BQ', 'AF', '2', 'EQ', 'DP', 'AP', 'BM', 'AF', 'BM', 'AF']",['110']
127,4,319,342,23,0,34,"['EY', '1', 'AA', '7', 'EQ', 'AP', 'BR', 'AF', 'BM', 'AF', '1', 'AD', 'FA', 'EU', '4', 'DL', 'ED', '15', 'ER', 'AP', 'DS', 'BQ', 'AF', 'DS', 'BQ', 'AF', '2', 'EQ', 'DP', 'AP', 'BM', 'AF', 'BM', 'AF']",['108']
128,4,319,377,58,0,34,"['EY', '1', 'AA', '7', 'EQ', 'AP', 'BR', 'AF', 'BM', 'AF', '1', 'AD', 'FA', 'EU', '4', 'DL', 'ED', '15', 'ER', 'AP', 'DS', 'BQ', 'AF', 'DS', 'BQ', 'AF', '2', 'EQ', 'DP', 'AP', 'BM', 'DK', 'BT', 'AF']",['107']
129,9,320,323,3,0,34,"['EY', '1', 'AA', '7', 'EQ', 'AP', 'BR', 'BM', 'BM', 'AF', '1', 'AD', 'FA', 'EU', '4', 'DL', 'ED', '15', 'ER', 'AP', 'DS', 'BQ', 'AF', 'DS', 'BQ', 'AF', '2', 'EQ', 'DP', 'AP', 'AF', 'AF', 'BM', 'AF']",['111']
130,9,323,356,33,0,36,"['EY', '1', 'AA', '7', 'EQ', 'AP', 'BR', 'AF', 'BM', '73', '27', 'AF', '1', 'AD', 'FA', 'EU', '4', 'DL', 'ED', '15', 'ER', 'AP', 'DS', 'BQ', 'AF', 'DS', 'BQ', 'AF', '2', 'EQ', 'DP', 'AP', 'BM', 'AF', 'BM', 'AF']",['112']
131,2,324,362,38,0,34,"['EY', '1', 'AA', '7', 'EQ', 'AP', 'BR', 'AF', 'BM', 'AF', '1', 'AD', 'FA', 'EU', '4', 'DL', 'ED', '15', 'ER', 'AP', 'DS', 'BQ', 'AF', 'DS', 'BQ', 'AF', '2', 'EQ', 'DP', 'AP', 'BM', 'AF', 'BM', 'AF']",['11']
132,2,324,338,14,0,34,"['EY', '1', 'AA', '7', 'EQ', 'AP', 'BR', 'AF', 'BM', 'AF', '1', 'AD', 'FA', 'EU', '4', 'DL', 'ED', '15', 'ER', 'AP', 'DS', 'BQ', 'AF', 'DS', 'BQ', 'AF', '2', 'EQ', 'DP', 'AP', 'BM', 'AF', 'BM', 'AF']",['19']
133,2,324,419,95,0,34,"['EY', '1', 'AA', '7', 'EQ', 'AP', 'BR', 'AF', 'BM', 'AF', '1', 'AD', 'FA', 'EU', '4', 'DL', 'ED', '15', 'ER', 'AP', 'DS', 'BQ', 'AF', 'DS', 'BQ', 'AF', '2', 'EQ', 'DP', 'AP', 'BM', 'AF', 'BM', 'AF']",['31']
134,14,327,328,1,0,34,"['EY', '1', 'AA', '7', 'EQ', 'AP', 'BR', 'AF', 'BM', 'AF', '1', 'AD', 'FA', 'EU', '4', 'DL', 'ED', '15', 'ER', 'AP', 'DS', 'BQ', 'AF', 'DS', 'BQ', 'AF', '2', 'EQ', 'DP', 'AP', 'BM', 'AF', 'BM', 'AF']",['79']
135,5,327,350,23,0,22,"['EY', 'EU', '4', 'DL', 'ED', '15', 'ER', 'AP', 'DS', 'BQ', 'AF', 'DS', 'BQ', 'AF', '2', 'EQ', 'DP', 'AP', 'BM', 'AF', 'BM', 'AF']",['85']
136,14,327,375,48,0,34,"['EY', '1', 'AA', '7', 'EQ', 'AP', 'BR', 'AF', 'BM', 'AF', '1', 'AD', 'FA', 'EU', '4', 'DL', 'ED', '15', 'ER', 'AP', 'DS', 'BQ', 'AF', 'DS', 'BQ', 'AF', '2', 'EQ', 'DP', 'AP', 'BM', 'AF', 'BM', 'AF']",['114']
137,7,328,371,43,0,34,"['EY', '1', 'AA', '7', 'EQ', 'AP', 'BR', 'AF', 'BM', 'AF', '1', 'AD', 'FA', 'EU', '4', 'DL', 'ED', '15', 'ER', 'AP', 'DS', 'BQ', 'AF', 'DS', 'BQ', 'AF', '2', 'EQ', 'DP', 'AP', 'BM', 'AF', 'BM', 'AF']",['118']
138,7,328,445,117,0,34,"['EY', '1', 'AA', 'AF', '1', 'AD', 'BR', 'AF', 'BM', '7', 'EQ', 'AP', 'FA', 'EU', '4', 'DL', 'ED', '15', 'ER', 'AP', 'DS', 'BQ', 'AF', 'DS', 'BQ', 'AF', '2', 'EQ', 'DP', 'AP', 'BM', 'AF', 'BM', 'AF']",['116']
139,7,328,470,142,0,37,"['EY', '1', 'AA', '7', 'EQ', 'AP', 'BR', 'AF', 'BM', 'AF', '1', 'AD', 'AF', 'BM', 'AF', 'FA', 'EU', '4', 'DL', 'ED', '15', 'ER', 'AP', 'DS', 'BQ', 'AF', 'DS', 'BQ', 'AF', '2', 'EQ', 'DP', 'AP', 'BM', 'AF', 'BM', 'AF']",['115']
140,12,332,542,210,0,34,"['EY', '1', 'AA', '7', 'EQ', 'AP', 'BR', 'AF', 'BM', 'AF', '1', 'AD', 'FA', 'EU', '4', 'DL', 'ED', '15', 'ER', 'AP', 'DS', 'BQ', 'AF', 'DS', 'BQ', 'AF', '2', 'EQ', 'DP', 'AP', 'BM', 'AF', 'BM', 'AF']",['54']
141,12,332,401,69,0,34,"['EY', '1', 'AA', '7', 'EQ', 'AP', 'BR', 'AF', 'BM', 'AF', '1', 'AD', 'FA', 'EU', '4', 'DL', 'ED', '15', 'ER', 'AP', 'DS', 'BQ', 'AF', 'DS', 'BQ', 'AF', '2', 'EQ', 'DP', 'AP', 'BM', 'AF', 'BM', 'AF']",['119']
142,5,333,347,14,0,34,"['EY', '1', 'AA', '7', 'EQ', 'AP', 'BR', 'AF', 'BM', 'AF', '1', 'AD', 'FA', 'EU', '4', 'DL', 'ED', '15', 'ER', 'AP', 'DS', 'BQ', 'AF', 'DS', 'BQ', 'AF', '2', 'EQ', 'DP', 'AP', 'BM', 'AF', 'BM', 'AF']",['57']
143,5,333,389,56,0,34,"['EY', '1', 'AA', '7', 'EQ', 'AP', 'BR', 'AF', 'BM', 'AF', '1', 'AD', 'FA', 'EU', '4', 'DL', 'ED', '15', 'ER', 'AP', 'DS', 'BQ', 'AF', 'DS', 'BQ', 'AF', '2', 'EQ', 'DP', 'AP', 'BM', 'AF', 'BM', 'AF']",['87']
144,5,333,381,48,0,31,"['EY', '1', 'AA', 'BR', 'AF', 'BM', 'AF', '1', 'AD', 'FA', 'EU', '4', 'DL', 'ED', '15', 'ER', 'AP', 'DS', 'BQ', 'AF', 'DS', 'BQ', 'AF', '2', 'EQ', 'DP', 'AP', 'BM', 'AF', 'BM', 'AF']",['84']
145,5,333,347,14,0,33,"['EY', '1', 'AA', '7', 'EQ', 'AP', 'BR', 'AF', 'BM', 'AF', '1', 'AD', 'FA', 'EU', '4', 'DL', 'ED', '15', 'ER', 'AP', 'DS', 'BQ', 'DS', 'BQ', 'AF', '2', 'EQ', 'DP', 'AP', 'BM', 'DK', 'BT', 'AF']",['128']
146,5,333,371,38,0,34,"['EY', '1', 'AA', '7', 'EQ', 'AP', 'BR', 'AF', 'BM', 'AF', '1', 'AD', 'FA', 'EU', '4', 'DL', 'ED', '15', 'ER', 'AP', 'DS', 'BQ', 'AF', 'DS', 'BQ', 'AF', '2', 'EQ', 'DP', 'AP', 'BM', 'AF', 'BM', 'AF']",['127']
147,5,333,409,76,0,34,"['EY', '1', 'AA', '7', 'EQ', 'AP', 'BR', 'AF', 'BM', 'AF', '1', 'AD', 'FA', 'EU', '4', 'DL', 'ED', '15', 'ER', 'AP', 'DS', 'BQ', 'AF', 'DS', 'BQ', 'AF', '2', 'EQ', 'DP', 'AP', 'BM', 'AF', 'BM', 'AF']",['125']
148,5,333,545,212,0,34,"['EY', '1', 'AA', '7', 'EQ', 'AP', 'BR', 'AF', 'BM', 'AF', '1', 'AD', 'FA', 'EU', '4', 'DL', 'ED', '15', 'ER', 'AP', 'DS', 'BQ', 'AF', 'DS', 'BQ', 'AF', '2', 'EQ', 'DP', 'AP', 'BM', 'AF', 'BM', 'AF']",['123']
149,5,333,399,66,0,34,"['EY', '1', 'AA', '7', 'EQ', 'AP', 'BR', 'AF', 'BM', 'AF', '1', 'AD', 'FA', 'EU', '4', 'DL', 'ED', '15', 'ER', 'AP', 'DS', 'BQ', 'AF', 'DS', 'BQ', 'AF', '2', 'EQ', 'DP', 'AP', 'BM', 'AF', 'BM', 'AF']",['120']
150,10,337,451,114,0,34,"['EY', '1', 'AA', '7', 'EQ', 'AP', 'BR', 'AF', 'BM', 'AF', '1', 'AD', 'FA', 'EU', '4', 'DL', 'ED', '15', 'ER', 'AP', 'DS', 'BQ', 'AF', 'DS', 'BQ', 'AF', '2', 'EQ', 'DP', 'AP', 'BM', 'AF', 'BM', 'AF']",['37']
151,3,338,612,274,0,34,"['EY', '1', 'AA', '7', 'EQ', 'AP', 'BR', 'AF', 'BM', 'AF', '1', 'AD', 'FA', 'EU', '4', 'DL', 'ED', '15', 'ER', 'AP', 'DS', 'BQ', 'AF', 'DS', 'BQ', 'AF', '2', 'EQ', 'DP', 'AP', 'BM', 'AF', 'BM', 'AF']",['41']
152,3,338,352,14,0,34,"['EY', '1', 'AA', '7', 'EQ', 'AP', 'BR', 'AF', 'BM', 'AF', '1', 'AD', 'FA', 'EU', '4', 'DL', 'ED', '15', 'ER', 'AP', 'DS', 'BQ', 'AF', 'DS', 'BQ', 'AF', '2', 'EQ', 'DP', 'AP', 'BM', 'AF', 'BM', 'AF']",['64']
153,3,338,366,28,0,34,"['EY', '1', 'AA', '7', 'EQ', 'AP', 'BR', 'AF', 'BM', 'AF', '1', 'AD', 'FA', 'EU', '4', 'DL', 'ED', '15', 'ER', 'AP', 'DS', 'BQ', 'AF', 'DS', 'BQ', 'AF', '2', 'EQ', 'DP', 'AP', 'BM', 'AF', 'BM', 'AF']",['95']
154,3,338,371,33,0,34,"['EY', '1', 'AA', '7', 'EQ', 'AP', 'BR', 'AF', 'BM', 'AF', '1', 'AD', 'FA', 'EU', '6', 'DL', 'ED', '-15', 'ER', 'AP', 'DS', 'BQ', 'AF', 'DS', 'BQ', 'AF', '6', 'EQ', 'DP', 'AP', 'BM', 'AF', 'BM', 'AF']",['93']
155,3,338,404,66,0,34,"['EY', '1', 'AA', '7', 'EQ', 'AP', 'BR', 'AF', 'BM', 'AF', '1', 'AD', 'FA', 'EU', '4', 'DL', 'ED', '15', 'ER', 'AP', 'DS', 'BQ', 'AF', 'DS', 'BQ', 'AF', '2', 'EQ', 'DP', 'AP', 'BM', 'AF', 'BM', 'AF']",['92']
156,3,338,344,6,0,34,"['EY', '1', 'AA', '7', 'EQ', 'AP', 'BR', 'AF', 'BM', 'AF', '1', 'AD', 'FA', 'EU', '4', 'DL', 'ED', '15', 'ER', 'AP', 'DS', 'BQ', 'AF', 'DS', 'BQ', 'AF', '2', 'EQ', 'DP', 'AP', 'BM', 'AF', 'BM', 'AF']",['133']
157,3,338,400,62,0,34,"['EY', '1', 'AA', '7', 'EQ', 'AP', 'BR', 'AF', 'BM', 'AF', '1', 'AD', 'FA', 'EU', '4', 'DL', 'ED', '15', 'ER', 'AP', 'DS', 'BQ', 'AF', 'DS', 'BQ', 'AF', '2', 'EQ', 'DP', 'AP', 'BM', 'AF', 'BM', 'AF']",['131']
158,6,339,362,23,0,22,"['EY', 'EU', '4', 'DL', 'ED', '15', 'ER', 'AP', 'DS', 'BQ', 'AF', 'DS', 'BQ', 'AF', '2', 'EQ', 'DP', 'AP', 'BM', 'AF', 'BM', 'AF']",['135']
159,6,341,376,35,0,34,"['EY', '1', 'AA', 'AF', '1', 'AD', 'BR', 'AF', 'BM', '7', 'EQ', 'AP', 'FA', 'EU', '4', 'DL', 'ED', '15', 'ER', 'AP', 'DS', 'BQ', 'AF', 'DS', 'BQ', 'AF', '2', 'EQ', 'DP', 'AP', 'BM', 'AF', 'BM', 'AF']",['102']
160,15,341,364,23,0,34,"['EY', '1', 'AA', '7', 'EQ', 'AP', 'BR', 'AF', 'BM', 'AF', '1', 'AD', 'FA', 'EU', '4', 'DL', 'ED', '15', 'ER', 'AP', 'DS', 'BQ', 'AF', 'DS', 'BQ', 'AF', '2', 'EQ', 'DP', 'AP', 'BM', 'AF', 'BM', 'AF']",['136']
161,8,342,413,71,0,34,"['EY', '1', 'AA', '7', 'EQ', 'AP', 'BR', 'AF', 'BM', 'AF', '1', 'AD', 'FA', 'EU', '4', 'DL', 'ED', '15', 'ER', 'AP', 'DS', 'BQ', 'AF', 'DS', 'BQ', 'AF', '2', 'EQ', 'DP', 'AP', 'BM', 'AF', 'BM', 'AF']",['25']
162,8,342,503,161,0,34,"['EY', '1', 'AA', '7', 'EQ', 'AP', 'BR', 'AF', 'BM', 'AF', '1', 'AD', 'FA', 'EU', '4', 'DL', 'ED', '15', 'ER', 'AP', 'DS', 'BQ', 'AF', 'DS', 'BQ', 'AF', '2', 'EQ', 'DP', 'AP', 'BM', 'AF', 'BM', 'AF']",['96']
163,8,342,381,39,0,37,"['EY', '1', 'AA', '7', 'EQ', 'AP', 'BR', 'AF', 'BM', 'AF', '1', 'AD', 'AF', 'BM', 'AF', 'FA', 'EU', '4', 'DL', 'ED', '15', 'ER', 'AP', 'DS', 'BQ', 'AF', 'DS', 'BQ', 'AF', '2', 'EQ', 'DP', 'AP', 'BM', 'AF', 'BM', 'AF']",['139']
164,8,342,1014,672,0,34,"['EY', '1', 'AA', 'AF', '1', 'AD', 'BR', 'AF', 'BM', '7', 'EQ', 'AP', 'FA', 'EU', '4', 'DL', 'ED', '15', 'ER', 'AP', 'DS', 'BQ', 'AF', 'DS', 'BQ', 'AF', '2', 'EQ', 'DP', 'AP', 'BM', 'AF', 'BM', 'AF']",['138']
165,8,342,418,76,0,34,"['EY', '1', 'AA', '7', 'EQ', 'AP', 'BR', 'AF', 'BM', 'AF', '1', 'AD', 'FA', 'EU', '4', 'DL', 'ED', '15', 'ER', 'AP', 'DS', 'BQ', 'AF', 'DS', 'BQ', 'AF', '2', 'EQ', 'DP', 'AP', 'BM', 'AF', 'BM', 'AF']",['137']
166,13,346,545,199,0,34,"['EY', '1', 'AA', '7', 'EQ', 'AP', 'BR', 'AF', 'BM', 'AF', '1', 'AD', 'FA', 'EU', '4', 'DL', 'ED', '15', 'ER', 'AP', 'DS', 'BQ', 'AF', 'DS', 'BQ', 'AF', '2', 'EQ', 'DP', 'AP', 'BM', 'AF', 'BM', 'AF']",['99']
167,13,346,412,66,0,34,"['EY', '-3', 'ES', '11', 'EQ', 'AP', 'BR', 'AF', 'BM', 'AF', '1', 'AD', 'FA', 'EU', '4', 'DL', 'ED', '15', 'ER', 'AP', 'DS', 'BQ', 'AF', 'DS', 'BQ', 'AF', '2', 'EQ', 'DP', 'AP', 'BM', 'AF', 'BM', 'AF']",['98']
168,6,347,414,67,0,34,"['EY', '1', 'AA', '7', 'EQ', 'AP', 'BR', 'AF', 'BM', 'AF', '1', 'AD', 'FA', 'EU', '4', 'DL', 'ED', '15', 'ER', 'AP', 'DS', 'BQ', 'AF', 'DS', 'BQ', 'AF', '2', 'EQ', 'DP', 'AP', 'BM', 'AF', 'BM', 'AF']",['44']
169,6,347,361,14,0,34,"['EY', '1', 'AA', '7', 'EQ', 'AP', 'BR', 'AF', 'BM', 'AF', '1', 'AD', 'FA', 'EU', '4', 'DL', 'ED', '15', 'ER', 'AP', 'DS', 'BQ', 'AF', 'DS', 'BQ', 'AF', '2', 'EQ', 'DP', 'AP', 'BM', 'AF', 'BM', 'AF']",['100']
170,6,347,366,19,0,35,"['EY', '1', 'AD', 'AA', '7', 'EQ', 'AP', 'BR', 'AF', 'BM', 'AF', '1', 'AD', 'FA', 'EU', '4', 'DL', 'ED', '15', 'ER', 'AP', 'DS', 'BQ', 'AF', 'DS', 'BQ', 'AF', '2', 'EQ', 'DP', 'AP', 'BM', 'AF', 'BM', 'AF']",['149']
171,6,347,361,14,0,34,"['EY', '1', 'AA', '7', 'EQ', 'AP', 'BR', 'AF', 'BM', 'AF', '1', 'AD', 'FA', 'EU', '4', 'DL', 'ED', '15', 'ER', 'AP', 'DS', 'BQ', 'AF', 'DS', 'BQ', 'AF', '2', 'EQ', 'DP', 'AP', 'BM', 'AF', 'BM', 'AF']",['148']
172,6,347,520,173,0,34,"['EY', '1', 'AA', '7', 'EQ', 'AP', 'BR', 'AF', 'BM', 'AF', '1', 'AD', 'FA', 'EU', '4', 'DL', 'ED', '15', 'ER', 'AP', 'DS', 'BQ', 'AF', 'DS', 'BQ', 'AF', '2', 'EQ', 'DP', 'AP', 'BM', 'AF', 'BM', 'AF']",['147']
173,6,347,376,29,0,34,"['EY', '1', 'AA', '7', 'EQ', 'AP', 'BR', 'AF', 'BM', 'AF', '1', 'AD', 'FA', 'EU', '4', 'DL', 'ED', '15', 'ER', 'AP', 'DS', 'BQ', 'AF', 'DS', 'BQ', 'AF', '2', 'EQ', 'DP', 'AP', 'BM', 'AF', 'BM', 'AF']",['146']
174,6,347,508,161,0,31,"['EY', '1', 'AA', 'BR', 'AF', 'BM', 'AF', '1', 'AD', 'FA', 'EU', '4', 'DL', 'ED', '15', 'ER', 'AP', 'DS', 'BQ', 'AF', 'DS', 'BQ', 'AF', '2', 'EQ', 'DP', 'AP', 'BM', 'AF', 'BM', 'AF']",['144']
175,6,347,508,161,0,34,"['EY', '1', 'AA', '7', 'EQ', 'AP', 'BR', 'AF', 'BM', 'AF', '1', 'AD', 'FA', 'EU', '4', 'DL', 'ED', '15', 'ER', 'AP', 'DS', 'BQ', 'AF', 'DS', 'BQ', 'AF', '2', 'EQ', 'DP', 'AP', 'BM', 'AF', 'BM', 'AF']",['143']
176,4,349,356,7,-41,34,"['EY', '1', 'AA', '7', 'EQ', 'AP', 'BR', 'AF', 'BM', 'AF', '1', 'AD', 'FA', 'EU', '4', 'DL', 'ED', '15', 'ER', 'AP', 'DS', 'BQ', 'AF', 'DS', 'BQ', 'AF', '2', 'EQ', 'DP', 'AP', 'BM', 'AF', 'BM', 'AF']","['109', '150']"
177,4,352,395,43,0,34,"['EY', '1', 'AA', '7', 'EQ', 'AP', 'BR', 'AF', 'BM', 'AF', '1', 'AD', 'FA', 'EU', '4', 'DL', 'ED', '15', 'ER', 'AP', 'DS', 'BQ', 'AF', 'DS', 'BQ', 'AF', '2', 'EQ', 'DP', 'AP', 'BM', 'AF', 'BM', 'AF']",['29']
178,4,352,428,76,0,34,"['EY', '1', 'AA', '7', 'EQ', 'AP', 'BR', 'AF', 'BM', 'AF', '1', 'AD', 'FA', 'EU', '4', 'DL', 'ED', '15', 'ER', 'AP', 'DS', 'BQ', 'AF', 'DS', 'BQ', 'AF', '2', 'EQ', 'DP', 'AP', 'BM', 'AF', 'BM', 'AF']",['72']
179,4,352,366,14,0,34,"['EY', '1', 'AA', '7', 'EQ', 'AP', 'BR', 'AF', 'BM', 'AF', '1', 'AD', 'FA', 'EU', '4', 'DL', 'ED', '15', 'ER', 'AP', 'DS', 'BQ', 'AF', 'DS', 'BQ', 'AF', '2', 'AN', 'AC', 'DV', 'DW', 'AF', 'BM', 'AF']",['71']
180,4,352,423,71,0,34,"['EY', '1', 'AA', '7', 'EQ', 'AP', 'BR', 'AF', 'BM', 'AF', '1', 'AD', 'FA', 'EU', '4', 'DL', 'ED', '15', 'ER', 'AP', 'DS', 'BQ', 'AF', 'DS', 'BQ', 'AF', '2', 'EQ', 'DP', 'AP', 'BM', 'AF', 'BM', 'AF']",['107']
181,4,352,703,351,0,34,"['EY', '1', 'AA', '7', 'EQ', 'AP', 'BR', 'AF', 'BM', 'AF', '1', 'AD', 'FA', 'EU', '4', 'DL', 'ED', '15', 'ER', 'AP', 'DS', 'BQ', 'AF', 'DS', 'BQ', 'AF', '2', 'EQ', 'DP', 'AP', 'BM', 'AF', 'BM', 'AF']",['157']
182,4,352,389,37,0,12,"['EY', '1', 'AA', '7', 'EQ', 'AP', 'BR', 'AF', 'BM', 'AF', '1', 'AD']",['154']
183,4,352,395,43,0,34,"['EY', '1', 'AA', '7', 'EQ', 'AP', 'BR', 'AF', 'BM', 'AF', '1', 'AD', 'FA', 'EU', '4', 'DL', 'ED', '15', 'ER', 'AP', 'DS', 'BQ', 'AF', 'DS', 'BQ', 'AF', '2', 'EQ', 'DP', 'AP', 'BM', 'AF', 'BM', 'AF']",['153']
184,4,352,447,95,0,34,"['EY', '1', 'AA', '7', 'EQ', 'AP', 'BR', 'AF', 'BM', 'AF', '1', 'AD', 'FA', 'EU', '4', 'DL', 'ED', '15', 'ER', 'AP', 'DS', 'BQ', 'AF', 'DS', 'BQ', 'AF', '2', 'EQ', 'DP', 'AP', 'BM', 'AF', 'BM', 'AF']",['151']
185,5,354,676,322,0,34,"['EY', '1', 'AA', 'AF', '1', 'AD', 'BR', 'AF', 'BM', '7', 'EQ', 'AP', 'FA', 'EU', '4', 'DL', 'ED', '15', 'ER', 'AP', 'DS', 'BQ', 'AF', 'DS', 'BQ', 'AF', '2', 'EQ', 'DP', 'AP', 'BM', 'AF', 'BM', 'AF']",['85']
186,7,355,758,403,0,34,"['EY', '1', 'AA', 'AF', '1', 'AD', 'BR', 'AF', 'BM', '7', 'EQ', 'AP', 'FA', 'EU', '4', 'DL', 'ED', '15', 'ER', 'AP', 'DS', 'BQ', 'AF', 'DS', 'BQ', 'AF', '2', 'EQ', 'DP', 'AP', 'BM', 'AF', 'BM', 'AF']",['116']
187,7,355,782,427,0,34,"['EY', '1', 'AA', 'AF', '1', 'AD', 'BR', 'AF', 'BM', '7', 'EQ', 'AP', 'FA', 'EU', '4', 'DL', 'ED', '15', 'ER', 'AP', 'DS', 'BQ', 'AF', 'DS', 'BQ', 'AF', '2', 'EQ', 'DP', 'AP', 'BM', 'AF', 'BM', 'AF']",['159']
188,9,356,523,167,0,34,"['EY', '1', 'AA', '7', 'EQ', 'AP', 'BR', 'AF', 'BM', 'AF', '1', 'AD', 'FA', 'EU', '4', 'DL', 'ED', '15', 'ER', 'AP', 'DS', 'BQ', 'AF', 'DS', 'BQ', 'AF', '2', 'EQ', 'DP', 'AP', 'BM', 'AF', 'BM', 'AF']",['165']
189,9,356,791,435,0,34,"['EY', '1', 'AA', 'AF', '1', 'AD', 'BR', 'AF', 'BM', '7', 'EQ', 'AP', 'FA', 'EU', '4', 'DL', 'ED', '15', 'ER', 'AP', 'DS', 'BQ', 'AF', 'DS', 'BQ', 'AF', '2', 'EQ', 'DP', 'AP', 'BM', 'AF', 'BM', 'AF']",['164']
190,9,356,418,62,0,37,"['EY', '1', 'AA', '7', 'EQ', 'AP', 'BR', 'AF', 'BM', 'AF', '1', 'AD', 'AF', 'BM', 'AF', 'FA', 'EU', '4', 'DL', 'ED', '15', 'ER', 'AP', 'DS', 'BQ', 'AF', 'DS', 'BQ', 'AF', '2', 'EQ', 'DP', 'AP', 'BM', 'AF', 'BM', 'AF']",['163']
191,9,356,436,80,0,34,"['EY', '1', 'AA', '7', 'EQ', 'AP', 'BR', 'AF', 'BM', 'AF', '1', 'AD', 'FA', 'EU', '4', 'DL', 'ED', '15', 'ER', 'AP', 'DS', 'BQ', 'AF', 'DS', 'BQ', 'AF', '2', 'EQ', 'DP', 'AP', 'BM', 'AF', 'BM', 'AF']",['162']
192,9,356,370,14,0,34,"['EY', '1', 'AA', '7', 'EQ', 'AP', 'BR', 'AF', 'BM', 'AF', '1', 'AD', 'FA', 'EU', '4', 'DL', 'ED', '15', 'ER', 'AP', 'DS', 'BQ', 'AF', 'DS', 'BQ', 'AF', '2', 'EQ', 'DP', 'AP', 'BM', 'AF', 'BM', 'AF']",['161']
193,2,357,549,192,0,34,"['EY', '1', 'AA', '7', 'EQ', 'AP', 'BR', 'AF', 'BM', 'AF', '1', 'AD', 'FA', 'EU', '4', 'DL', 'ED', '15', 'ER', 'AP', 'DS', 'BQ', 'AF', 'DS', 'BQ', 'AF', '2', 'EQ', 'DP', 'AP', 'BM', 'AF', 'BM', 'AF']",['11']
194,2,357,399,42,0,34,"['EY', '1', 'AA', '7', 'EQ', 'AP', 'BR', 'AF', 'BM', 'AF', '1', 'AD', 'FA', 'EU', '4', 'DL', 'ED', '15', 'ER', 'AP', 'DS', 'BQ', 'AF', 'DS', 'BQ', 'AF', '2', 'EQ', 'DP', 'AP', 'BM', 'AF', 'BM', 'AF']",['19']
195,2,357,358,1,0,34,"['EY', '1', 'AA', '7', 'EQ', 'AP', 'BR', 'AF', 'BM', 'AF', '1', 'AD', 'FA', 'EU', '4', 'DL', 'ED', '15', 'ER', 'AP', 'DS', 'BQ', 'AF', 'DS', 'BQ', 'AF', '2', 'EQ', 'DP', 'AP', 'BM', 'AF', 'BM', 'AF']",['31']
196,9,358,360,2,0,36,"['EY', '1', 'AA', '7', 'EQ', 'AP', 'BR', 'AF', 'BM', '73', '27', 'AF', '1', 'AD', 'FA', 'EU', '4', 'DL', 'ED', '15', 'ER', 'AP', 'DS', 'BQ', 'AF', 'DS', 'BQ', 'AF', '2', 'EQ', 'DP', 'AP', 'BM', 'AF', 'BM', 'AF']",['112']
197,7,358,389,31,58,30,"['EY', '1', 'AA', '7', 'EQ', 'AP', 'BR', 'AF', 'FA', 'EU', '4', 'DL', 'ED', '15', 'ER', 'AP', 'DS', 'BQ', 'AF', 'DS', 'BQ', 'AF', '2', 'EQ', 'DP', 'AP', 'BM', 'AF', 'BM', 'AF']","['115', '173']"
198,14,360,407,47,0,34,"['EY', '1', 'AA', '7', 'EQ', 'AP', 'BR', 'AF', 'BM', 'AF', '1', 'AD', 'FA', 'EU', '4', 'DL', 'ED', '15', 'ER', 'AP', 'DS', 'BQ', 'AF', 'DS', 'BQ', 'AF', '2', 'EQ', 'DP', 'AP', 'BM', 'AF', 'BM', 'AF']",['79']
199,14,360,366,6,0,38,"['EY', 'AT', 'BJ', 'EC', 'EV', 'FA', 'AA', '7', 'EQ', 'AP', 'BR', 'AF', 'BM', 'AF', '1', 'AD', 'FB', 'EU', '4', 'DL', 'ED', '15', 'ER', 'AP', 'DS', 'BQ', 'AF', 'DS', 'BQ', 'AF', '2', 'EQ', 'DP', 'AP', 'BM', 'AF', 'BM', 'AF']",['166']
200,7,361,451,90,0,33,"['EY', '1', 'AA', '7', 'EQ', 'AP', 'BR', 'AF', 'BM', 'AF', '1', 'AD', 'FA', 'EU', '4', 'DL', 'ED', '15', 'ER', 'AP', 'DS', 'BQ', 'AF', 'DS', 'AF', '2', 'EQ', 'DP', 'AP', 'BM', 'AF', 'BM', 'AF']",['118']
201,7,361,380,19,0,34,"['EY', '1', 'AA', '7', 'EQ', 'AP', 'BR', 'AF', 'BM', 'AF', '1', 'AD', 'FA', 'EU', '4', 'DL', 'ED', '15', 'ER', 'AP', 'DS', 'BQ', 'AF', 'DS', 'BQ', 'AF', '2', 'EQ', 'DP', 'AP', 'BM', 'AF', 'BM', 'AF']",['175']
202,7,361,394,33,0,31,"['EY', '1', 'AA', 'BR', 'AF', 'BM', 'AF', '1', 'AD', 'FA', 'EU', '4', 'DL', 'ED', '15', 'ER', 'AP', 'DS', 'BQ', 'AF', 'DS', 'BQ', 'AF', '2', 'EQ', 'DP', 'AP', 'BM', 'AF', 'BM', 'AF']",['174']
203,7,361,536,175,0,35,"['EY', '1', 'AA', '7', 'EQ', 'AP', 'BR', 'AF', 'BM', 'AF', '1', 'AD', 'FA', 'EU', '4', 'DL', 'ED', '15', 'ER', 'AP', 'DS', 'BQ', 'AF', 'DS', 'BQ', 'AF', '2', 'EQ', 'DP', 'AP', 'BM', 'AF', 'BM', 'AF', 'FB']",['168']
204,12,365,388,23,0,34,"['EY', '1', 'AA', '7', 'EQ', 'AP', 'BR', 'AF', 'BM', 'AF', '1', 'AD', 'FA', 'EU', '4', 'DL', 'ED', '15', 'ER', 'AP', 'DS', 'BQ', 'AF', 'DS', 'BQ', 'AF', '2', 'EQ', 'DP', 'AP', 'BM', 'AF', 'BM', 'AF']",['119']
205,5,366,441,75,0,34,"['EY', '1', 'AA', '7', 'EQ', 'AP', 'BR', 'AF', 'BM', 'AF', '1', 'AD', 'FA', 'EU', '4', 'DL', 'ED', '15', 'ER', 'AP', 'DS', 'BQ', 'AF', 'DS', 'BQ', 'AF', '2', 'EQ', 'DP', 'AP', 'BM', 'AF', 'BM', 'AF']",['57']
206,5,366,442,76,0,34,"['EY', '1', 'AA', '7', 'EQ', 'AP', 'BR', 'AF', 'BM', 'AF', '1', 'AD', 'FA', 'EU', '4', 'DL', 'ED', '15', 'ER', 'AP', 'DS', 'BQ', 'AF', 'DS', 'BQ', 'AF', '2', 'EQ', 'DP', 'AP', 'BM', 'AF', 'BM', 'AF']",['87']
207,5,366,410,44,0,34,"['EY', '1', 'AA', '7', 'EQ', 'AP', 'BR', 'AF', 'BM', 'AF', '1', 'AD', 'FA', 'EU', '4', 'DL', 'ED', '15', 'ER', 'AP', 'DS', 'BQ', 'AF', 'DS', 'BQ', 'AF', '2', 'EQ', 'DP', 'AP', 'BM', 'AF', 'BM', 'AF']",['84']
208,5,366,409,43,0,34,"['EY', '1', 'AA', '7', 'EQ', 'AP', 'BR', 'AF', 'BM', 'AF', '1', 'AD', 'FA', 'EU', '4', 'DL', 'ED', '15', 'ER', 'AP', 'DS', 'BQ', 'AF', 'DS', 'BQ', 'AF', '2', 'EQ', 'DP', 'AP', 'BM', 'DK', 'BT', 'AF']",['128']
209,5,366,375,9,0,34,"['EY', '1', 'AA', '7', 'EQ', 'AP', 'BR', 'AF', 'BM', 'AF', '1', 'AD', 'FA', 'EU', '4', 'DL', 'ED', '15', 'ER', 'AP', 'DS', 'BQ', 'AF', 'DS', 'BQ', 'AF', '2', 'EQ', 'DP', 'AP', 'BM', 'AF', 'BM', 'AF']",['125']
210,5,366,380,14,0,34,"['EY', '1', 'AA', '7', 'EQ', 'AP', 'BR', 'AF', 'BM', 'AF', '1', 'AD', 'FA', 'EU', '4', 'DL', 'ED', '15', 'ER', 'AP', 'DS', 'BQ', 'AF', 'DS', 'BQ', 'AF', '2', 'EQ', 'DP', 'AP', 'BM', 'AF', 'BM', 'AF']",['124']
211,5,366,380,14,0,34,"['EY', '1', 'AA', '7', 'EQ', 'AP', 'BR', 'AF', 'BM', 'AF', '1', 'AD', 'FA', 'EU', '4', 'DL', 'ED', '15', 'ER', 'AP', 'DS', 'BQ', 'AF', 'DS', 'BQ', 'AF', '2', 'EQ', 'DP', 'AP', 'BM', 'AF', 'BM', 'AF']",['123']
212,5,366,428,62,0,34,"['EY', '1', 'AA', '7', 'EQ', 'AP', 'BR', 'AF', 'BM', 'AF', '1', 'AD', 'FA', 'EU', '4', 'DL', 'ED', '15', 'ER', 'AP', 'DS', 'BQ', 'AF', 'DS', 'BQ', 'AF', '2', 'EQ', 'DP', 'AP', 'BM', 'AF', 'BM', 'AF']",['121']
213,5,366,541,175,0,34,"['EY', '1', 'AA', '7', 'EQ', 'AP', 'BR', 'AF', 'BM', 'AF', '1', 'AD', 'FA', 'EU', '4', 'DL', 'ED', '15', 'ER', 'AP', 'DS', 'BQ', 'AF', 'DS', 'BQ', 'AF', '2', 'EQ', 'DP', 'AP', 'BM', 'AF', 'BM', 'AF']",['184']
214,5,366,451,85,0,34,"['EY', '1', 'AA', '7', 'EQ', 'AP', 'BR', 'AF', 'BM', 'AF', '1', 'AD', 'FA', 'EU', '4', 'DL', 'ED', '15', 'ER', 'AP', 'DS', 'BQ', 'AF', 'DS', 'BQ', 'AF', '2', 'EQ', 'DP', 'AP', 'BM', 'AF', 'BM', 'AF']",['183']
215,5,366,385,19,0,34,"['EY', '1', 'AA', '7', 'EQ', 'AP', 'BR', 'AF', 'BM', 'AF', '1', 'AD', 'FA', 'EU', '4', 'DL', 'ED', '15', 'ER', 'AP', 'DS', 'BQ', 'AF', 'DS', 'BQ', 'AF', '2', 'EQ', 'DP', 'AP', 'BM', 'AF', 'BM', 'AF']",['181']
216,5,366,397,31,0,30,"['EY', '1', 'AA', '7', 'EQ', 'AP', 'BR', 'AF', 'FA', 'EU', '4', 'DL', 'ED', '15', 'ER', 'AP', 'DS', 'BQ', 'AF', 'DS', 'BQ', 'AF', '2', 'EQ', 'DP', 'AP', 'BM', 'AF', 'BM', 'AF']",['180']
217,5,366,418,52,0,34,"['EY', '1', 'AA', '7', 'EQ', 'AP', 'BR', 'AF', 'BM', 'AF', '1', 'AD', 'FA', 'EU', '4', 'DL', 'ED', '15', 'EI', 'AD', 'BP', 'EQ', 'AF', 'DS', 'BQ', 'AF', '2', 'EQ', 'DP', 'AP', 'BM', 'AF', 'BM', 'AF']",['178']
218,5,366,411,45,0,34,"['EY', '1', 'AA', '7', 'EQ', 'AP', 'BR', 'AF', 'BM', 'AF', '1', 'AD', 'FA', 'EU', '4', 'DL', 'ED', '15', 'ER', 'AP', 'DS', 'BQ', 'AF', 'DS', 'BQ', 'AF', '2', 'EQ', 'DP', 'AP', 'BM', 'AF', 'BM', 'AF']",['177']
219,6,368,447,79,0,34,"['EY', '1', 'AA', 'AF', '1', 'AD', 'BR', 'AF', 'BM', '7', 'EQ', 'AP', 'FA', 'EU', '4', 'DL', 'ED', '15', 'ER', 'AP', 'DS', 'BQ', 'AF', 'DS', 'BQ', 'AF', '2', 'EQ', 'DP', 'AP', 'BM', 'AF', 'BM', 'AF']",['102']
220,6,368,706,338,0,34,"['EY', '1', 'AA', 'AF', '1', 'AD', 'BR', 'AF', 'BM', '7', 'EQ', 'AP', 'FA', 'EU', '4', 'DL', 'ED', '15', 'ER', 'AP', 'DS', 'BQ', 'AF', 'DS', 'BQ', 'AF', '2', 'EQ', 'DP', 'AP', 'BM', 'AF', 'BM', 'AF']",['185']
221,8,369,692,323,0,38,"['EY', '1', 'AA', 'AF', '1', 'AD', 'BR', 'AF', 'BM', '7', 'EQ', 'AP', 'FA', 'EU', '4', 'DL', 'ED', '15', 'ER', 'AP', 'DS', 'BQ', 'AF', 'DS', 'BQ', 'AF', '2', 'EQ', 'DP', 'AP', 'BM', 'AF', 'BM', 'AF', 'FB', '54', '-39', 'AD']",['138']
222,8,369,387,18,0,34,"['EY', '1', 'AA', 'AF', '1', 'AD', 'BR', 'AF', 'BM', '7', 'EQ', 'AP', 'FA', 'EU', '4', 'DL', 'ED', '15', 'ER', 'AP', 'DS', 'BQ', 'AF', 'DS', 'BQ', 'AF', '2', 'EQ', 'DP', 'AP', 'BM', 'AF', 'BM', 'AF']",['187']
223,8,369,1244,875,0,35,"['EY', '1', 'AA', 'AF', '1', 'AD', 'BR', 'AF', 'BM', '7', 'EQ', 'AP', 'FA', 'EU', '4', 'DL', 'ED', '15', 'ER', 'AP', 'DS', 'BQ', 'AF', 'DS', 'BQ', 'AF', '2', 'EQ', 'EU', 'DP', 'AP', 'BM', 'AF', 'BM', 'AF']",['186']
224,10,370,461,91,0,34,"['EY', '1', 'AA', '7', 'EQ', 'AP', 'BR', 'AF', 'BM', 'AF', '1', 'AD', 'FA', 'EU', '4', 'DL', 'ED', '15', 'ER', 'AP', 'DS', 'BQ', 'AF', 'DS', 'BQ', 'AF', '2', 'EQ', 'DP', 'AP', 'BM', 'AF', 'BM', 'AF']",['37']
225,10,370,412,42,0,34,"['EY', '1', 'AA', '7', 'EQ', 'AP', 'BR', 'AF', 'BM', 'AF', '1', 'AD', 'FA', 'EU', '4', 'DL', 'ED', '15', 'ER', 'AP', 'DS', 'BQ', 'AF', 'DS', 'BQ', 'AF', '2', 'EQ', 'DP', 'AP', 'BM', 'AF', 'BM', 'AF']",['191']
226,10,370,488,118,0,37,"['EY', '1', 'AA', '7', 'EQ', 'AP', 'BR', 'AF', 'BM', 'AF', '1', 'AD', 'AF', 'BM', 'AF', 'FA', 'EU', '4', 'DL', 'ED', '15', 'ER', 'AP', 'DS', 'BQ', 'AF', 'DS', 'BQ', 'AF', '2', 'EQ', 'DP', 'AP', 'BM', 'AF', 'BM', 'AF']",['190']
227,10,370,725,355,0,34,"['EY', '1', 'AA', 'AF', '1', 'AD', 'BR', 'AF', 'BM', '7', 'EQ', 'AP', 'FA', 'EU', '4', 'DL', 'ED', '15', 'ER', 'AP', 'DS', 'BQ', 'AF', 'DS', 'BQ', 'AF', '2', 'EQ', 'DP', 'AP', 'BM', 'AF', 'BM', 'AF']",['189']
228,10,370,384,14,0,34,"['EY', '1', 'AA', '7', 'EQ', 'AP', 'BR', 'AF', 'BM', 'AF', '1', 'AD', 'FA', 'EU', '4', 'DL', 'ED', '15', 'ER', 'AP', 'DS', 'BQ', 'AF', 'DS', 'BQ', 'AF', '2', 'EQ', 'DP', 'AP', 'BM', 'AF', 'BM', 'AF']",['188']
229,3,371,398,27,0,34,"['EY', '1', 'AA', '7', 'EQ', 'AP', 'BR', 'AF', 'BM', 'AF', '1', 'AD', 'FA', 'EU', '4', 'DL', 'ED', '15', 'ER', 'AP', 'DS', 'BQ', 'AF', 'DS', 'BQ', 'AF', '2', 'EQ', 'DP', 'AP', 'BM', 'AF', 'BM', 'AF']",['41']
230,3,371,431,60,0,34,"['EY', '1', 'AA', '7', 'EQ', 'AP', 'BR', 'AF', 'BM', 'AF', '1', 'AD', 'FA', 'EU', '4', 'DL', 'ED', '15', 'ER', 'AP', 'DS', 'BQ', 'AF', 'DS', 'BQ', 'AF', '2', 'EQ', 'DP', 'AP', 'BM', 'AF', 'BM', 'AF']",['64']
231,3,371,446,75,0,34,"['EY', '1', 'AA', '7', 'EQ', 'AP', 'BR', 'AF', 'BM', 'AF', '1', 'AD', 'FA', 'EU', '4', 'DL', 'ED', '15', 'ER', 'AP', 'DS', 'BQ', 'AF', 'DS', 'BQ', 'AF', '2', 'EQ', 'DP', 'AP', 'BM', 'AF', 'BM', 'AF']",['95']
232,3,371,385,14,0,34,"['EY', '1', 'AA', '7', 'EQ', 'AP', 'BR', 'AF', 'BM', 'AF', '1', 'AD', 'FA', 'EU', '4', 'DL', 'ED', '15', 'ER', 'AP', 'DS', 'BQ', 'AF', 'DS', 'BQ', 'AF', '2', 'EQ', 'DP', 'AP', 'BM', 'AF', 'BM', 'AF']",['93']
233,3,371,450,79,0,12,"['EY', '2', 'AA', '11', 'EQ', 'AP', 'BR', 'AF', 'BM', 'AF', '-1', 'AD']",['92']
234,3,371,385,14,0,34,"['EY', '1', 'AA', '7', 'EQ', 'AP', 'BR', 'AF', 'BM', 'AF', '1', 'AD', 'FA', 'EU', '4', 'DL', 'ED', '15', 'ER', 'AP', 'DS', 'BQ', 'AF', 'DS', 'BQ', 'AF', '2', 'EQ', 'DP', 'AP', 'BM', 'AF', 'BM', 'AF']",['133']
235,3,371,470,99,0,34,"['EY', '1', 'AA', '7', 'EQ', 'AP', 'BR', 'AF', 'BM', 'AF', '1', 'AD', 'FA', 'EU', '4', 'DL', 'ED', '15', 'ER', 'AP', 'DS', 'BQ', 'AF', 'DS', 'BQ', 'AF', '2', 'EQ', 'DP', 'AP', 'BM', 'AF', 'BM', 'AF']",['194']
236,3,371,466,95,0,34,"['EY', '1', 'AA', '7', 'EQ', 'AP', 'BR', 'AF', 'BM', 'AF', '1', 'AD', 'FA', 'EU', '4', 'DL', 'ED', '15', 'ER', 'AP', 'DS', 'BQ', 'AF', 'DS', 'BQ', 'AF', '2', 'EQ', 'DP', 'AP', 'BM', 'AF', 'BM', 'AF']",['193']
237,8,372,401,29,0,28,"['EY', '1', 'AA', '7', 'EQ', 'AF', 'FA', 'EU', '4', 'DL', 'ED', '15', 'ER', 'AP', 'DS', 'BQ', 'AF', 'DS', 'BQ', 'AF', '2', 'EQ', 'DP', 'AP', 'BM', 'AF', 'BM', 'AF']",['197']
238,15,374,385,11,0,34,"['EY', '1', 'AA', '7', 'EQ', 'AP', 'EC', 'EM', 'EW', 'EW', '1', 'AD', 'FA', 'EU', '4', 'DL', 'ED', '15', 'ER', 'AP', 'DS', 'BQ', 'AF', 'DS', 'BQ', 'AF', '2', 'EQ', 'DP', 'AP', 'BM', 'AF', 'BM', 'AF']",['136']
239,15,374,388,14,0,34,"['EY', '1', 'AA', '7', 'EQ', 'AP', 'BR', 'AF', 'BM', 'AF', '1', 'AD', 'FA', 'EU', '4', 'DL', 'ED', '15', 'ER', 'AP', 'DS', 'BQ', 'AF', 'DS', 'BQ', 'AF', '2', 'EQ', 'DP', 'AP', 'BM', 'AF', 'BM', 'AF']",['198']
240,8,375,417,42,0,34,"['EY', '1', 'AA', '7', 'EQ', 'AP', 'BR', 'AF', 'BM', 'AF', '1', 'AD', 'FA', 'EU', '4', 'DL', 'ED', '15', 'ER', 'AP', 'DS', 'BQ', 'AF', 'DS', 'BQ', 'AF', '2', 'EQ', 'DP', 'AP', 'BM', 'AF', 'BM', 'AF']",['96']
241,8,375,380,5,0,37,"['EY', '1', 'AA', '7', 'EQ', 'AP', 'BR', 'AF', 'BM', 'AF', '1', 'AD', 'AF', 'BM', 'AF', 'FA', 'EU', '4', 'DL', 'ED', '15', 'ER', 'AP', 'DS', 'BQ', 'AF', 'DS', 'BQ', 'AF', '2', 'EQ', 'DP', 'AP', 'BM', 'AF', 'BM', 'AF']",['139']
242,8,375,475,100,0,35,"['EY', '1', 'AA', '7', 'EQ', 'AP', 'BR', 'AF', 'BM', 'AF', '1', 'AD', 'FA', 'EU', '4', 'DL', 'ED', '15', 'ER', 'AP', 'DS', 'BQ', 'AF', 'DS', 'BQ', 'AF', '2', 'EQ', 'DP', 'AP', 'BM', 'AF', 'BM', 'AF', 'FB']",['203']
243,8,375,541,166,0,31,"['EY', '1', 'AA', 'BR', 'AF', 'BM', 'AF', '1', 'AD', 'FA', 'EU', '4', 'DL', 'ED', '15', 'ER', 'AP', 'DS', 'BQ', 'AF', 'DS', 'BQ', 'AF', '2', 'EQ', 'DP', 'AP', 'BM', 'AF', 'BM', 'AF']",['202']
244,8,375,649,274,0,34,"['EY', '1', 'AA', '7', 'EQ', 'AP', 'BR', 'AF', 'BM', 'AF', '1', 'AD', 'FA', 'EU', '4', 'DL', 'ED', '15', 'ER', 'AP', 'DS', 'BQ', 'AF', 'DS', 'BQ', 'AF', '2', 'EQ', 'DP', 'AP', 'BM', 'AF', 'BM', 'AF']",['201']
245,13,376,617,241,42,34,"['EY', '1', 'AA', '7', 'EQ', 'AP', 'BR', 'AF', 'BM', 'AF', '1', 'AD', 'FA', 'EU', '4', 'DL', 'ED', '15', 'ER', 'AP', 'DS', 'BQ', 'AF', 'DS', 'BQ', 'AF', '2', 'EQ', 'DP', 'AP', 'BM', 'AF', 'BM', 'AF']","['99', '141']"
246,6,377,394,17,0,31,"['EY', '1', 'AA', 'BR', 'AF', 'BM', 'AF', '1', 'AD', 'FA', 'EU', '4', 'DL', 'ED', '15', 'ER', 'AP', 'DS', 'BQ', 'AF', 'DS', 'BQ', 'AF', '2', 'EQ', 'DP', 'AP', 'BM', 'AF', 'BM', 'AF']",['144']
247,6,377,456,79,63,34,"['EY', '1', 'AA', '7', 'EQ', 'AP', 'BR', 'AF', 'BM', 'AF', '1', 'AD', 'FA', 'EU', '4', 'DL', 'ED', '15', 'ER', 'AP', 'DS', 'BQ', 'AF', 'DS', 'BQ', 'AF', '2', 'EQ', 'DP', 'AP', 'BM', 'AF', 'BM', 'AF']","['211', '148']"
248,13,379,398,19,0,34,"['EY', '1', 'AA', '7', 'EQ', 'AP', 'BR', 'AF', 'BM', 'AF', '1', 'AD', 'FA', 'EU', '4', 'DL', 'ED', '15', 'ER', 'AP', 'DS', 'BQ', 'AF', 'DS', 'BQ', 'AF', '2', 'EQ', 'DP', 'AP', 'BM', 'AF', 'BM', 'AF']",['67']
249,13,379,405,26,0,36,"['EY', '1', '-98', '-22', 'AA', '7', 'EQ', 'AP', 'BR', 'AF', 'BM', 'AF', '1', 'AD', 'FA', 'EU', '4', 'DL', 'ED', '15', 'ER', 'AP', 'DS', 'BQ', 'AF', 'DS', 'BQ', 'AF', '2', 'EQ', 'DP', 'AP', 'BM', 'AF', 'BM', 'AF']",['204']
250,6,380,394,14,0,34,"['EY', '1', 'AA', '7', 'EQ', 'AP', 'BR', 'AF', 'BM', 'AF', '1', 'AD', 'FA', 'EU', '4', 'DL', 'ED', '15', 'ER', 'AP', 'DS', 'BQ', 'AF', 'DS', 'BQ', 'AF', '2', 'EQ', 'DP', 'AP', 'BM', 'AF', 'BM', 'AF']",['44']
251,6,380,394,14,0,34,"['EY', '1', 'AA', '7', 'EQ', 'AP', 'BR', 'AF', 'BM', 'AF', '1', 'AD', 'FA', 'EU', '4', 'DL', 'ED', '15', 'ER', 'AP', 'DS', 'BQ', 'AF', 'DS', 'BQ', 'AF', '2', 'EQ', 'DP', 'AP', 'BM', 'AF', 'BM', 'AF']",['100']
252,6,380,394,14,0,34,"['EY', '1', 'AA', '7', 'EQ', 'AP', 'BR', 'AF', 'BM', 'AF', '1', 'AD', 'FA', 'EU', '4', 'DL', 'ED', '15', 'ER', 'AP', 'DS', 'BQ', 'AF', 'DS', 'BQ', 'AF', '2', 'EQ', 'DP', 'AP', 'BM', 'AF', 'BM', 'AF']",['149']
253,6,380,423,43,0,34,"['EY', '1', 'AA', '7', 'EQ', 'AP', 'BR', 'AF', 'BM', 'AF', '1', 'AD', 'FA', 'EU', '4', 'DL', 'ED', '15', 'ER', 'AP', 'DS', 'BQ', 'AF', 'DS', 'BQ', 'AF', '2', 'EQ', 'DP', 'AP', 'BM', 'AF', 'BM', 'AF']",['147']
254,6,380,420,40,0,34,"['EY', '1', 'AA', '7', 'EQ', 'AP', 'BR', 'AF', 'BM', 'AF', '1', 'AD', 'FA', 'EU', '4', 'DL', 'ED', '15', 'ER', 'AP', 'DS', 'BQ', 'AF', 'DS', 'BQ', 'AF', '2', 'EQ', 'DP', 'AP', 'BM', 'AF', 'BM', 'AF']",['143']
255,6,380,399,19,0,34,"['EY', '1', 'AA', '7', 'EQ', 'AP', 'BR', 'AF', 'BM', 'AF', '1', 'AD', 'FA', 'EU', '4', 'DL', 'ED', '15', 'ER', 'AP', 'DS', 'BQ', 'AF', 'DS', 'BQ', 'AF', '2', 'EQ', 'DP', 'AP', 'BM', 'AF', 'BM', 'AF']",['218']
256,6,380,394,14,0,30,"['EY', '1', 'AA', '7', 'EQ', 'AP', 'BR', 'AF', 'FA', 'EU', '4', 'DL', 'ED', '15', 'ER', 'AP', 'DS', 'BQ', 'AF', 'DS', 'BQ', 'AF', '2', 'EQ', 'DP', 'AP', 'BM', 'AF', 'BM', 'AF']",['216']
257,6,380,446,66,0,34,"['EY', '1', 'AA', '7', 'EQ', 'AP', 'BR', 'AF', 'BM', 'AF', '1', 'AD', 'FA', 'EU', '4', 'DL', 'ED', '15', 'ER', 'AP', 'DS', 'BQ', 'AF', 'DS', 'BQ', 'AF', '2', 'EQ', 'DP', 'AP', 'BM', 'AF', 'BM', 'AF']",['215']
258,6,380,479,99,0,34,"['EY', '1', 'AA', '7', 'EQ', 'AP', 'BR', 'AF', 'BM', 'AF', 'AF', 'DS', 'FA', 'EU', '4', 'DL', 'ED', '15', 'ER', 'AP', 'DS', 'BQ', '1', 'AD', 'BQ', 'AF', '2', 'EQ', 'DP', 'AP', 'BM', 'AF', 'BM', 'AF']",['213']
259,6,380,648,268,0,34,"['EY', '1', 'AA', '7', 'EQ', 'AP', 'BR', 'AF', 'BM', 'AF', '1', 'AD', 'FA', 'EU', '4', 'DL', 'ED', '15', 'ER', 'AP', 'DS', 'BQ', 'AF', 'DS', 'BQ', 'AF', '2', 'EQ', 'DP', 'AP', 'BM', 'DK', 'BT', 'AF']",['208']
260,6,380,399,19,0,34,"['EY', '1', 'AA', '7', 'EQ', 'AP', 'BR', 'AF', 'BM', 'AF', '1', 'AD', 'FA', 'EU', '4', 'DL', 'ED', '15', 'ER', 'AP', 'DS', 'BQ', 'AF', 'DS', 'BQ', 'AF', '2', 'EQ', 'DP', 'AP', 'BM', 'AF', 'BM', 'AF']",['207']
261,6,380,403,23,0,34,"['EY', '1', 'AA', '7', 'EQ', 'AP', 'BR', 'AF', 'BM', 'AF', '1', 'AD', 'FA', 'EU', '4', 'DL', 'ED', '15', 'ER', 'AP', 'DS', 'BQ', 'AF', 'DS', 'BQ', 'AF', '2', 'EQ', 'DP', 'AP', 'BM', 'AF', 'BM', 'AF']",['206']
262,6,380,394,14,0,12,"['EY', '1', 'AA', '7', 'EQ', 'AP', 'BR', 'AF', 'BM', 'AF', '1', 'AD']",['205']
263,5,381,413,32,0,34,"['EY', '1', 'AA', 'AF', '1', 'AD', 'BR', 'AF', 'BM', '7', 'EQ', 'AP', 'FA', 'EU', '4', 'DL', 'ED', '15', 'ER', 'AP', 'DS', 'BQ', 'AF', 'DS', 'BQ', 'AF', '2', 'EQ', 'DP', 'AP', 'BM', 'AF', 'BM', 'AF']",['85']
264,7,382,427,45,0,35,"['EY', '1', 'AA', 'AF', '1', 'AD', 'BR', 'AF', 'BM', '7', 'EQ', 'AP', 'FA', 'EU', '4', 'DL', 'ED', '15', 'ER', 'AP', 'DS', 'BQ', 'AF', 'EG', 'DS', 'BQ', 'AF', '2', 'EQ', 'DP', 'AP', 'BM', 'AF', 'BM', 'AF']",['116']
265,7,382,545,163,0,34,"['EY', '1', 'AA', 'AF', '1', 'AD', 'BR', 'AF', 'BM', '7', 'EQ', 'AP', 'FA', 'EU', '4', 'DL', 'ED', '15', 'ER', 'AP', 'DS', 'BQ', 'AF', 'DS', 'BQ', 'AF', '2', 'EQ', 'DP', 'AP', 'BM', 'AF', 'BM', 'AF']",['220']
266,7,382,470,88,0,34,"['EY', '1', 'AA', 'AF', '1', 'AD', 'BR', 'AF', 'BM', '7', 'EQ', 'AP', 'FA', 'EU', '4', 'DL', 'ED', '15', 'ER', 'AP', 'DS', 'BQ', 'AF', 'DS', 'BQ', 'AF', '2', 'EQ', 'DP', 'AP', 'BM', 'AF', 'BM', 'AF']",['219']
267,4,382,524,142,80,34,"['EY', '1', 'AA', '7', 'EQ', 'AP', 'BR', 'AF', 'BM', 'AF', '1', 'AD', 'FA', 'EU', '4', 'DL', 'ED', '15', 'ER', 'AP', 'DS', 'BQ', 'AF', 'DS', 'BQ', 'AF', '2', 'EQ', 'DP', 'AP', 'BM', 'AF', 'BM', 'AF']","['155', '235']"
268,9,383,772,389,0,34,"['EY', '1', 'AA', 'AF', '1', 'AD', 'BR', 'AF', 'BM', '7', 'EQ', 'AP', 'FA', 'EU', '4', 'DL', 'ED', '15', 'ER', 'AP', 'DW', 'DU', 'AF', 'DS', 'BQ', 'AF', '2', 'EQ', 'DP', 'AP', 'BM', 'AF', 'BM', 'AF']",['164']
269,9,383,875,492,0,35,"['EY', '1', 'AA', 'AF', '1', 'AD', 'BR', 'AF', 'BM', '7', 'EQ', 'AP', 'FA', 'EU', '4', 'DL', 'ED', '15', 'ER', 'AP', 'DS', 'BQ', 'AF', 'DS', 'BQ', 'AF', '2', 'EQ', 'EU', 'DP', 'AP', 'BM', 'AF', 'BM', 'AF']",['223']
270,9,383,765,382,0,34,"['EY', '1', 'AA', 'AF', '1', 'AD', 'BR', 'AF', 'BM', '7', 'EQ', 'AP', 'FA', 'EU', '4', 'DL', 'ED', '15', 'ER', 'AP', 'DS', 'BQ', 'AF', 'DS', 'BQ', 'AF', '2', 'EQ', 'DP', 'AP', 'BM', 'AF', 'BM', 'AF']",['222']
271,9,383,797,414,0,38,"['EY', '1', 'AA', 'AF', '1', 'AD', 'BR', 'AF', 'BM', '7', 'EQ', 'AP', 'FA', 'EU', '4', 'DL', 'ED', '15', 'ER', 'AP', 'DS', 'BQ', 'AF', 'DS', 'BQ', 'AF', '2', 'EQ', 'DP', 'AP', 'BM', 'AF', 'BM', 'AF', 'FB', '54', '-39', 'AD']",['221']
272,11,384,454,70,0,34,"['EY', '1', 'AA', '7', 'EQ', 'AP', 'BR', 'AF', 'BM', 'AF', '1', 'AD', 'FA', 'EU', '4', 'DL', 'ED', '15', 'ER', 'AP', 'DS', 'BQ', 'AF', 'DS', 'BQ', 'AF', '2', 'EQ', 'DP', 'AP', 'BM', 'AF', 'BM', 'AF']",['150']
273,11,384,617,233,0,34,"['EY', '1', 'AA', 'AF', '1', 'AD', 'BR', 'AF', 'BM', '7', 'EQ', 'AP', 'FA', 'EU', '4', 'DL', 'ED', '15', 'ER', 'AP', 'DS', 'BQ', 'AF', 'DS', 'BQ', 'AF', '2', 'EQ', 'DP', 'AP', 'BM', 'AF', 'BM', 'AF']",['227']
274,11,384,389,5,0,37,"['EY', '1', 'AA', '7', 'EQ', 'AP', 'BR', 'AF', 'BM', 'AF', '1', 'AD', 'AF', 'BM', 'AF', 'FA', 'EU', '4', 'DL', 'ED', '15', 'ER', 'AP', 'DS', 'BQ', 'AF', 'DS', 'BQ', 'AF', '2', 'EQ', 'DP', 'AP', 'BM', 'AF', 'BM', 'AF']",['226']
275,4,385,432,47,0,34,"['EY', '1', 'AA', '7', 'EQ', 'AP', 'BR', 'AF', 'BM', 'AF', '1', 'AD', 'FA', 'EU', '4', 'DL', 'ED', '15', 'ER', 'AP', 'DS', 'BQ', 'AF', 'DS', 'BQ', 'AF', '2', 'EQ', 'DP', 'AP', 'BM', 'AF', 'BM', 'AF']",['29']
276,4,385,428,43,0,34,"['EY', '1', 'AA', '7', 'EQ', 'AP', 'BR', 'AF', 'BM', 'AF', '1', 'AD', 'FA', 'EU', '4', 'DL', 'ED', '15', 'ER', 'AP', 'DS', 'BQ', 'AF', 'DS', 'BQ', 'AF', '2', 'EQ', 'DP', 'AP', 'BM', 'AF', 'BM', 'AF']",['72']
277,4,385,545,160,0,34,"['EY', '1', 'AA', '7', 'EQ', 'AP', 'BR', 'AF', 'BM', 'AF', '1', 'AD', 'FA', 'EU', '4', 'DL', 'ED', '15', 'ER', 'AP', 'DS', 'BQ', 'AF', 'DS', 'BQ', 'AF', '2', 'EQ', 'DP', 'AP', 'BM', 'AF', 'BM', 'AF']",['71']
278,4,385,399,14,0,34,"['EY', '1', 'AA', '7', 'EQ', 'AP', 'BR', 'AF', 'BM', 'AF', '1', 'AD', 'FA', 'EU', '4', 'DL', 'ED', '15', 'ER', 'AP', 'DS', 'BQ', 'AF', 'DS', 'BQ', 'AF', '2', 'EQ', 'DP', 'AP', 'BM', 'AF', 'BM', 'AF']",['157']
279,4,385,413,28,0,34,"['EY', '1', 'AA', '7', 'EQ', 'AP', 'BR', 'AF', 'BM', 'AF', '1', 'AD', 'FA', 'EU', '4', 'DL', 'ED', '15', 'ER', 'AP', 'DS', 'BQ', 'AF', 'DS', 'BQ', 'AF', '2', 'EQ', 'DP', 'AP', 'BM', 'AF', 'BM', 'AF']",['151']
280,4,385,430,45,0,34,"['EY', '1', 'AA', '7', 'EQ', 'AP', 'BR', 'AF', 'BM', 'AF', '1', 'AD', 'FA', 'EU', '4', 'DL', 'ED', '15', 'ER', 'AP', 'DS', 'BQ', 'AF', 'DS', 'BQ', 'AF', '2', 'EQ', 'DP', 'AP', 'BM', 'AF', 'BM', 'AF']",['236']
281,4,385,538,153,0,34,"['EY', '1', 'AA', '7', 'EQ', 'AP', 'BR', 'AF', 'BM', 'AF', '1', 'AD', 'FA', 'EU', '4', 'DL', 'ED', '15', 'ER', 'AP', 'DS', 'BQ', 'AF', 'DS', 'BQ', 'AF', '2', 'EQ', 'DP', 'AP', 'BM', 'AF', 'BM', 'AF']",['231']
282,4,385,393,8,0,34,"['EY', '1', 'AA', '7', 'EQ', 'AP', 'BR', 'AF', 'BM', 'AF', '1', 'AD', 'FA', 'EU', '4', 'DL', 'ED', '15', 'ER', 'AP', 'DS', 'BQ', 'AF', 'DS', 'BQ', 'AF', '2', 'EQ', 'DP', 'AP', 'BM', 'AF', 'BM', 'AF']",['230']
283,4,385,403,18,0,33,"['EY', '1', 'AA', '7', 'EQ', 'AP', 'BR', 'AF', 'BM', 'AF', '1', 'AD', 'FA', 'EU', '4', 'DL', '15', 'ER', 'AP', 'DS', 'BQ', 'AF', 'DS', 'BQ', 'AF', '2', 'EQ', 'DP', 'AP', 'BM', 'AF', 'BM', 'AF']",['229']
284,9,386,399,13,0,28,"['EY', '1', 'AA', '7', 'EQ', 'AF', 'FA', 'EU', '4', 'DL', 'ED', '15', 'ER', 'AP', 'DS', 'BQ', 'AF', 'DS', 'BQ', 'AF', '2', 'EQ', 'DP', 'AP', 'BM', 'AF', 'BM', 'AF']",['237']
285,9,389,403,14,0,34,"['EY', '1', 'AA', '7', 'EQ', 'AP', 'BR', 'AF', 'BM', 'AF', '1', 'AD', 'FA', 'EU', '4', 'DL', 'ED', '15', 'ER', 'AP', 'DS', 'BQ', 'AF', 'DS', 'BQ', 'AF', '2', 'EQ', 'DP', 'AP', 'BM', 'AF', 'BM', 'AF']",['165']
286,9,389,427,38,0,34,"['EY', '1', 'AA', '7', 'EQ', 'AP', 'BR', 'AF', 'BM', 'AF', '1', 'AD', 'FA', 'EU', '4', 'DL', 'ED', '15', 'ER', 'AP', 'DS', 'BQ', 'AF', 'DS', 'BQ', 'AF', '2', 'EQ', 'DP', 'AP', 'BM', 'AF', 'BM', 'AF']",['162']
287,9,389,398,9,0,34,"['EY', '1', 'AA', '7', 'EQ', 'AP', 'BR', 'AF', 'BM', 'AF', '1', 'AD', 'FA', 'EU', '4', 'DL', 'ED', '15', 'ER', 'AP', 'DS', 'BQ', 'AF', 'DS', 'BQ', 'AF', '2', 'EQ', 'DP', 'AP', 'BM', 'AF', 'BM', 'AF']",['161']
288,9,389,502,113,0,34,"['EY', '1', 'AA', '7', 'EQ', 'AP', 'BR', 'AF', 'BM', 'AF', '1', 'AD', 'FA', 'EU', '4', 'DL', 'ED', '15', 'ER', 'AP', 'DS', 'BQ', 'AF', 'DS', 'BQ', 'AF', '2', 'EQ', 'DP', 'AP', 'BM', 'AF', 'BM', 'AF']",['244']
289,9,389,428,39,0,35,"['EY', '1', 'AA', '7', 'EQ', 'AP', 'BR', 'AF', 'BM', 'AF', '1', 'AD', 'FA', 'EU', '4', 'DL', 'ED', '15', 'ER', 'AP', 'DS', 'BQ', 'AF', 'DS', 'BQ', 'AF', '2', 'EQ', 'DP', 'AP', 'BM', 'AF', 'BM', 'AF', 'FB']",['242']
290,9,389,403,14,0,34,"['EY', '1', 'AA', '7', 'EQ', 'AP', 'BR', 'AF', 'BM', 'AF', '1', 'AD', 'FA', 'EU', '4', 'DL', 'ED', '15', 'ER', 'AP', 'DS', 'BQ', 'AF', 'DS', 'BQ', 'AF', '2', 'EQ', 'DP', 'AP', 'BM', 'AF', 'BM', 'AF']",['240']
291,2,390,460,70,0,34,"['EY', '1', 'AA', '7', 'EQ', 'AP', 'BR', 'AF', 'BM', 'AF', '1', 'AD', 'FA', 'EU', '4', 'DL', 'ED', '15', 'ER', 'AP', 'DS', 'BQ', 'AF', 'DS', 'BQ', 'AF', '2', 'EQ', 'DP', 'AP', 'BM', 'AF', 'BM', 'AF']",['11']
292,14,390,393,3,0,32,"['EY', '1', 'AA', '7', 'EQ', 'AP', 'BR', 'AF', 'BM', 'AF', '1', 'AD', 'FA', 'EU', '4', 'DL', 'ED', '15', 'ER', 'AP', 'DS', 'BQ', 'AF', 'DS', 'BQ', 'AF', '2', 'EQ', 'DP', 'AF', 'BM', 'AF']",['245']
293,7,391,946,555,0,31,"['EY', '1', 'AA', 'BR', 'AF', 'BM', 'AF', '1', 'AD', 'FA', 'EU', '4', 'DL', 'ED', '15', 'ER', 'AP', 'DS', 'BQ', 'AF', 'DS', 'BQ', 'AF', '2', 'EQ', 'DP', 'AP', 'BM', 'AF', 'BM', 'AF']",['174']
294,7,391,434,43,0,34,"['EY', '1', 'AA', '7', 'EQ', 'AP', 'BR', 'AF', 'BM', 'AF', '1', 'AD', 'FA', 'EU', '4', 'DL', 'ED', '15', 'ER', 'AP', 'DS', 'BQ', 'AF', 'DS', 'BQ', 'AF', '2', 'EQ', 'DP', 'AP', 'BM', 'AF', 'BM', 'AF']",['247']
295,7,391,399,8,0,31,"['EY', '1', 'AA', 'BR', 'AF', 'BM', 'AF', '1', 'AD', 'FA', 'EU', '4', 'DL', 'ED', '15', 'ER', 'AP', 'DS', 'BQ', 'AF', 'DS', 'BQ', 'AF', '2', 'EQ', 'DP', 'AP', 'BM', 'AF', 'BM', 'AF']",['246']
296,14,393,664,271,0,34,"['EY', '1', 'AA', '7', 'EQ', 'AP', 'BR', 'AF', 'BM', 'AF', '1', 'AD', 'FA', 'EU', '4', 'DL', 'ED', '15', 'ER', 'AP', 'DS', 'BQ', 'AF', 'DS', 'BQ', 'AF', '2', 'EQ', 'DP', 'AP', 'BM', 'AF', 'BM', 'AF']",['79']
297,14,393,441,48,0,39,"['EY', '1', 'AA', '7', 'EQ', 'AP', 'BR', 'AF', 'BM', 'AF', '1', 'AD', 'FA', '-5', 'BJ', '-91', '5', 'FB', 'EU', '4', 'DL', 'ED', '15', 'ER', 'AP', 'DS', 'BQ', 'AF', 'DS', 'BQ', 'AF', '2', 'EQ', 'DP', 'AP', 'BM', 'AF', 'BM', 'AF']",['166']
298,14,393,460,67,0,34,"['EY', '1', 'AA', '7', 'EQ', 'AP', 'BR', 'AF', 'BM', 'AF', '1', 'AD', 'FA', 'EU', '4', 'DL', 'ED', '15', 'ER', 'AP', 'DS', 'BQ', 'AF', 'DS', 'BQ', 'AF', '2', 'EQ', 'DP', 'AP', 'BM', 'AF', 'BM', 'AF']",['248']
299,8,393,408,15,127,34,"['EY', '1', 'AA', 'AF', '1', 'AD', 'BR', 'AF', 'BM', '7', 'EQ', 'AP', 'FA', 'EU', '4', 'DL', 'ED', '15', 'ER', 'AP', 'DS', 'BQ', 'AF', 'DS', 'BQ', 'AF', '2', 'EQ', 'DP', 'AP', 'BM', 'AF', 'BM', 'AF']","['265', '138']"
300,7,394,427,33,0,34,"['EY', '1', 'AA', '7', 'EQ', 'AP', 'BR', 'AF', 'BM', 'AF', '1', 'AD', 'FA', 'EU', '4', 'DL', 'ED', '15', 'ER', 'AP', 'DS', 'BQ', 'AF', 'DS', 'BQ', 'AF', '2', 'EQ', 'DP', 'AP', 'BM', 'AF', 'BM', 'AF']",['175']
301,7,394,536,142,0,34,"['EY', '1', 'AA', '7', 'EQ', 'AP', 'BR', 'AF', 'BM', 'AF', '1', 'AD', 'FA', 'EU', '4', 'DL', 'ED', '15', 'ER', 'AP', 'DS', 'BQ', 'AF', 'DS', 'BQ', 'AF', '2', 'EQ', 'DP', 'AP', 'BM', 'AF', 'BM', 'AF']",['172']
302,7,394,432,38,0,34,"['EY', '1', 'AA', '7', 'EQ', 'AP', 'BR', 'AF', 'BM', 'AF', '1', 'AD', 'FA', 'EU', '4', 'DL', 'ED', '15', 'ER', 'AP', 'DS', 'BQ', 'AF', 'DS', 'BQ', 'AF', '2', 'EQ', 'DP', 'AP', 'BM', 'AF', 'BM', 'AF']",['168']
303,7,394,421,27,0,34,"['EY', '1', 'AA', '7', 'EQ', 'AP', 'BR', 'AF', 'BM', 'AF', '1', 'AD', 'FA', 'EU', '4', 'DL', 'ED', '15', 'ER', 'AP', 'DS', 'BQ', 'AF', 'DS', 'BQ', 'AF', '2', 'EQ', 'DP', 'AP', 'BM', 'AF', 'BM', 'AF']",['261']
304,7,394,429,35,0,34,"['EY', '1', 'AA', '7', 'EQ', 'AP', 'BR', 'AF', 'EI', 'EO', '-2', 'AE', 'FA', 'EU', '4', 'DL', 'ED', '15', 'ER', 'AP', 'DS', 'BQ', 'AF', 'DS', 'BQ', 'AF', '2', 'EQ', 'DP', 'AP', 'BM', 'AF', 'BM', 'AF']",['260']
305,7,394,437,43,0,34,"['EY', '1', 'AA', '7', 'EQ', 'AP', 'BR', 'AF', 'BM', 'AF', '1', 'AD', 'FA', 'EU', '4', 'DL', 'ED', '15', 'ER', 'AP', 'DS', 'BQ', 'AF', 'DS', 'BQ', 'AF', '2', 'EQ', 'DP', 'AP', 'BM', 'DK', 'BT', 'AF']",['259']
306,7,394,673,279,0,34,"['EY', '1', 'AA', '7', 'EQ', 'AP', 'BR', 'AF', 'BM', 'AF', '1', 'AD', 'FA', 'EU', '4', 'DL', 'ED', '15', 'ER', 'AP', 'DS', 'BQ', 'AF', 'DS', 'BQ', 'AF', '2', 'EQ', 'DP', 'AP', 'BM', 'AF', 'BM', 'AF']",['257']
307,7,394,517,123,0,34,"['EY', '1', 'AA', '7', 'EQ', 'AP', 'BR', 'AF', 'BM', 'AF', '1', 'AD', 'FA', 'EU', '4', 'DL', 'ED', '15', 'ER', 'AP', 'DS', 'BQ', 'AF', 'DS', 'BQ', 'AF', '2', 'EQ', 'DP', 'AP', 'BM', 'AF', 'BM', 'AF']",['255']
308,7,394,408,14,0,34,"['EY', '1', 'AA', '7', 'EQ', 'AP', 'BR', 'AF', 'BM', 'AF', '1', 'AD', 'FA', 'EU', '4', 'DL', 'ED', '15', 'ER', 'AP', 'DS', 'BQ', 'AF', 'DS', 'BQ', 'AF', '2', 'EQ', 'DP', 'AP', 'BM', 'AF', 'BM', 'AF']",['254']
309,7,394,470,76,0,34,"['EY', '1', 'AA', '7', 'EQ', 'AP', 'BR', 'AF', 'BM', 'AF', '1', 'AD', 'FA', 'EU', '4', 'DL', 'ED', '15', 'ER', 'AP', 'DS', 'BQ', 'AF', 'DS', 'BQ', 'AF', '2', 'EQ', 'DP', 'AP', 'BM', 'AQ', 'BK', 'AI']",['253']
310,10,394,612,218,80,35,"['EY', '1', 'AA', 'AF', '1', 'AD', 'BR', 'AF', 'BM', '7', 'EQ', 'AP', 'FA', 'EU', '4', 'DL', 'ED', '15', 'ER', 'AP', 'DS', 'BQ', 'AF', 'DS', 'BQ', 'AF', '2', 'EQ', 'EU', 'DP', 'AP', 'BM', 'AF', 'BM', 'AF']","['269', '189']"
311,6,395,413,18,0,34,"['EY', '1', 'AA', 'AF', '1', 'AD', 'BR', 'AF', 'BM', '7', 'EQ', 'AP', 'FA', 'EU', '4', 'DL', 'ED', '15', 'ER', 'AP', 'DS', 'BQ', 'AF', 'DS', 'BQ', 'AF', '2', 'EQ', 'DP', 'AP', 'BM', 'AF', 'BM', 'AF']",['102']
312,6,395,724,329,0,34,"['EY', '1', 'AA', 'AF', '1', 'AD', 'BR', 'AF', 'BM', '7', 'EQ', 'AP', 'FA', 'EU', '4', 'DL', 'ED', '15', 'ER', 'AP', 'DS', 'BQ', 'AF', 'DS', 'BQ', 'AF', '2', 'EQ', 'DP', 'AP', 'BM', 'AF', 'BM', 'AF']",['185']
313,6,395,724,329,0,34,"['EY', '1', 'AA', 'AF', '1', 'AD', 'BR', 'AF', 'BM', '7', 'EQ', 'AP', 'FA', 'EU', '4', 'DL', 'ED', '15', 'ER', 'AP', 'DS', 'BQ', 'AF', 'DS', 'BQ', 'AF', '2', 'EQ', 'DP', 'AP', 'BM', 'AF', 'BM', 'AF']",['263']
314,8,396,592,196,0,34,"['EY', '1', 'AA', 'AF', '1', 'AD', 'BR', 'AF', 'BM', '7', 'EQ', 'AP', 'FA', 'EU', '4', 'DL', 'ED', '15', 'ER', 'AP', 'DS', 'BQ', 'AF', 'DS', 'BQ', 'AF', '2', 'EQ', 'DP', 'AP', 'BM', 'AF', 'BM', 'AF']",['187']
315,8,396,941,545,0,12,"['EY', '1', 'AA', 'AF', '1', 'AD', 'BR', 'AF', 'BM', '7', 'EQ', 'AP']",['186']
316,5,396,440,44,0,34,"['EY', '1', 'AA', '7', 'EQ', 'AP', 'BR', 'AF', 'BM', 'AF', '1', 'AD', 'FA', 'EU', '4', 'DL', 'ED', '15', 'ER', 'AP', 'DS', 'BQ', 'AF', 'DS', 'BQ', 'AF', '2', 'EQ', 'DP', 'AP', 'BM', 'AF', 'BM', 'AF']",['267']
317,8,396,491,95,0,35,"['EY', '1', 'AA', 'AF', '1', 'AD', 'BR', 'AF', 'BM', '41', '7', 'EQ', 'AP', 'FA', 'EU', '4', 'DL', 'ED', '15', 'ER', 'AP', 'DS', 'BQ', 'AF', 'DS', 'BQ', 'AF', '2', 'EQ', 'DP', 'AP', 'BM', 'AF', 'BM', 'AF']",['266']
318,5,396,466,70,95,34,"['EY', '1', 'AA', '7', 'EQ', 'AP', 'BR', 'AF', 'BM', 'AF', '1', 'AD', 'FA', 'EU', '4', 'DL', 'ED', '15', 'ER', 'AP', 'DS', 'BQ', 'AF', 'DS', 'BQ', 'AF', '2', 'EQ', 'DP', 'AP', 'BM', 'AF', 'BM', 'AF']","['184', '279']"
319,10,397,599,202,0,38,"['EY', '1', 'AA', 'AF', '1', 'AD', 'BR', 'AF', 'BM', '7', 'EQ', 'AP', 'FA', 'EU', '4', 'DL', 'ED', '15', 'ER', 'AP', 'DS', 'BQ', 'AF', 'DS', 'BQ', 'AF', '2', 'EQ', 'DP', 'AP', 'BM', 'AF', 'BM', 'AF', 'FB', '54', '-39', 'AD']",['271']
320,10,397,537,140,0,34,"['EY', '1', 'AA', 'AF', '1', 'AD', 'BR', 'AF', 'BM', '7', 'EQ', 'AP', 'FA', 'EU', '4', 'DL', 'ED', '15', 'ER', 'AP', 'DS', 'BQ', 'AF', 'DS', 'BQ', 'AF', '2', 'EQ', 'DP', 'AP', 'BM', 'AF', 'BM', 'AF']",['270']
321,12,398,473,75,0,34,"['EY', '1', 'AA', '7', 'EQ', 'AP', 'BR', 'AF', 'BM', 'AF', '1', 'AD', 'FA', 'EU', '4', 'DL', 'ED', '15', 'ER', 'AP', 'DS', 'BQ', 'AF', 'DS', 'BQ', 'AF', '2', 'EQ', 'DP', 'AP', 'BM', 'AF', 'BM', 'AF']",['119']
322,12,398,546,148,0,34,"['EY', '1', 'AA', 'AF', '1', 'AD', 'BR', 'AF', 'BM', '7', 'EQ', 'AP', 'FA', 'EU', '4', 'DL', 'ED', '15', 'ER', 'AP', 'DS', 'BQ', 'AF', 'DS', 'BQ', 'AF', '2', 'EQ', 'DP', 'AP', 'BM', 'AF', 'BM', 'AF']",['273']
323,12,398,461,63,0,34,"['EY', '1', 'AA', '7', 'EQ', 'AP', 'BR', 'AF', 'BM', 'AF', '1', 'AD', 'FA', 'EU', '4', 'DL', 'ED', '15', 'ER', 'AP', 'DS', 'BQ', 'AF', 'DS', 'BQ', 'AF', '2', 'EQ', 'DP', 'AP', 'BM', 'AF', 'BM', 'AF']",['272']
324,5,399,408,9,0,34,"['EY', '1', 'AA', '7', 'EQ', 'AP', 'BR', 'AF', 'BM', 'AF', '1', 'AD', 'FA', 'EU', '4', 'DL', 'ED', '15', 'ER', 'AP', 'DS', 'BQ', 'AF', 'DS', 'BQ', 'AF', '2', 'EQ', 'DP', 'AP', 'BM', 'AF', 'BM', 'AF']",['57']
325,5,399,461,62,0,34,"['EY', '1', 'AA', '7', 'EQ', 'AP', 'BR', 'AF', 'BM', 'AF', '1', 'AD', 'FA', 'EU', '4', 'DL', 'ED', '15', 'ER', 'AP', 'DS', 'BQ', 'AF', 'DS', 'BQ', 'AF', '2', 'EQ', 'DP', 'AP', 'BM', 'AF', 'BM', 'AF']",['124']
326,5,399,405,6,0,34,"['EY', '1', 'AA', '7', 'EQ', 'AP', 'BR', 'AF', 'BM', 'AF', '1', 'AD', 'FA', 'EU', '4', 'DL', 'ED', '15', 'ER', 'AP', 'DS', 'BQ', 'AF', 'DS', 'BQ', 'AF', '2', 'EQ', 'DP', 'AP', 'BM', 'AF', 'BM', 'AF']",['123']
327,5,399,439,40,0,34,"['EY', '1', 'AA', '7', 'EQ', 'AP', 'BR', 'AF', 'DZ', 'DM', '-3', 'AD', 'FA', 'EU', '4', 'DL', 'ED', '15', 'ER', 'AP', 'DS', 'BQ', 'AF', 'DS', 'BQ', 'AF', '2', 'EQ', 'DP', 'AP', 'BM', 'AF', 'BM', 'AF']",['121']
328,5,399,413,14,0,34,"['EY', '1', 'AA', '7', 'EQ', 'AP', 'BR', 'AF', 'BM', 'AF', '1', 'AD', 'FA', 'EU', '4', 'DL', 'ED', '15', 'ER', 'AP', 'DS', 'BQ', 'AF', 'DS', 'BQ', 'AF', '2', 'EQ', 'DP', 'AP', 'BM', 'AF', 'BM', 'AF']",['181']
329,5,399,442,43,0,34,"['EY', '1', 'AA', '7', 'EQ', 'AP', 'BR', 'AF', 'BM', 'AF', '1', 'AD', 'FA', 'EU', '4', 'DL', 'ED', '15', 'ER', 'AP', 'DS', 'BQ', 'AF', 'DS', 'BQ', 'AF', '2', 'EQ', 'DP', 'AP', 'BM', 'AF', 'BM', 'AF']",['180']
330,5,399,470,71,0,34,"['EY', '1', 'AA', '7', 'EQ', 'AP', 'BR', 'AF', 'BM', 'AF', '1', 'AD', 'FA', 'EU', '4', 'DL', 'ED', '15', 'ER', 'AP', 'DS', 'BQ', 'AF', 'DS', 'BQ', 'AF', '2', 'EQ', 'DP', 'AP', 'BM', 'AF', 'BM', 'AF']",['178']
331,5,399,502,103,0,34,"['EY', '1', 'AA', '7', 'EQ', 'AP', 'BR', 'AF', 'BM', 'AF', '1', 'AD', 'FA', 'EU', '4', 'DL', 'ED', '15', 'ER', 'AP', 'DS', 'BQ', 'AF', 'DS', 'BQ', 'AF', '2', 'EQ', 'DP', 'AP', 'BM', 'AF', 'BM', 'AF']",['281']
332,5,399,404,5,0,34,"['EY', '1', 'AA', '7', 'EQ', 'AP', 'BR', 'AF', 'BM', 'AF', '1', 'AD', 'FA', 'EU', '4', 'DL', 'ED', '15', 'ER', 'AP', 'DS', 'BQ', 'AF', 'DS', 'BQ', 'AF', '2', 'EQ', 'DP', 'AP', 'BM', 'AF', 'BM', 'AF']",['280']
333,5,399,413,14,0,34,"['EY', '1', 'AA', '7', 'EQ', 'AP', 'BR', 'AF', 'BM', 'AF', '1', 'AD', 'FA', 'EU', '4', 'DL', 'ED', '15', 'ER', 'AP', 'DS', 'BQ', 'AF', 'DS', 'BQ', 'AF', '2', 'EQ', 'DP', 'AP', 'BM', 'AF', 'BM', 'AF']",['277']
334,5,399,541,142,0,34,"['EY', '1', 'AA', '7', 'EQ', 'AP', 'BR', 'AF', 'BM', 'AF', '1', 'AD', 'FA', 'EU', '4', 'DL', 'ED', '15', 'ER', 'AP', 'DS', 'BQ', 'AF', 'DS', 'BQ', 'AF', '2', 'EQ', 'DP', 'AP', 'BM', 'AF', 'BM', 'AF']",['276']
335,5,399,413,14,0,34,"['EY', '1', 'AA', '7', 'EQ', 'AP', 'BR', 'AF', 'BM', 'AF', '1', 'AD', 'FA', 'EU', '4', 'DL', 'ED', '15', 'ER', 'AP', 'DS', 'BQ', 'AF', 'DS', 'BQ', 'AF', '2', 'EQ', 'DP', 'AP', 'BM', 'AF', 'BM', 'AF']",['275']
336,10,400,592,192,97,34,"['EY', '1', 'AA', '7', 'EQ', 'AP', 'BR', 'AF', 'BM', 'AF', '1', 'AD', 'FA', 'EU', '4', 'DL', 'ED', '15', 'ER', 'AP', 'DS', 'BQ', 'AF', 'DS', 'BQ', 'AF', '2', 'EQ', 'DP', 'AP', 'BM', 'AF', 'BM', 'AF']","['188', '285']"
337,10,403,493,90,0,34,"['EY', '1', 'AA', '7', 'EQ', 'AP', 'BR', 'AF', 'BM', 'AF', '1', 'AD', 'FA', 'EU', '4', 'DL', 'ED', '15', 'ER', 'AP', 'DS', 'BQ', 'AF', 'DS', 'BQ', 'AF', '2', 'EQ', 'DP', 'AP', 'BM', 'AF', 'BM', 'AF']",['37']
338,10,403,451,48,0,34,"['EY', '1', 'AA', '7', 'EQ', 'AP', 'BR', 'AF', 'BM', 'AF', '1', 'AD', 'FA', 'EU', '4', 'DL', 'ED', '15', 'ER', 'AP', 'DS', 'BQ', 'AF', 'DS', 'BQ', 'AF', '2', 'EQ', 'DP', 'AP', 'BM', 'AF', 'BM', 'AF']",['191']
339,10,403,465,62,0,15,"['EY', '1', 'AA', '7', 'EQ', 'AP', 'BR', 'AF', 'BM', 'AF', '1', 'AD', 'AF', 'BM', 'AF']",['190']
340,10,403,536,133,0,35,"['EY', '1', 'AA', '7', 'EQ', 'AP', 'BR', 'AF', 'BM', 'AF', '1', 'AD', 'FA', 'EU', '4', 'DL', 'ED', '15', 'ER', 'AP', 'DS', 'BQ', 'AF', 'DS', 'BQ', 'AF', '2', 'EQ', 'DP', 'AP', 'BM', 'AF', 'BM', 'AF', 'FB']",['289']
341,10,403,436,33,0,12,"['EY', '1', 'AA', '7', 'EQ', 'AP', 'BR', 'AF', 'BM', 'AF', '1', 'AD']",['288']
342,10,403,475,72,0,32,"['EY', '1', 'AA', '7', 'EQ', 'AP', 'BR', 'AF', 'BM', 'AF', '1', 'AD', 'FA', 'EU', '6', 'EV', 'ED', '15', 'ER', 'AP', 'DS', 'BQ', 'AF', 'DS', 'BQ', 'AF', '2', 'AP', 'BM', 'AF', 'BM', 'AF']",['286']
343,3,404,474,70,0,34,"['EY', '1', 'AA', '7', 'EQ', 'AP', 'BR', 'AF', 'BM', 'AF', '1', 'AD', 'FA', 'EU', '4', 'DL', 'ED', '15', 'ER', 'AP', 'DS', 'BQ', 'AF', 'DS', 'BQ', 'AF', '2', 'EQ', 'DP', 'AP', 'BM', 'AF', 'BM', 'AF']",['41']
344,3,404,417,13,0,34,"['EY', '1', 'AA', '7', 'EQ', 'AP', 'BR', 'AF', 'BM', 'AF', '1', 'AD', 'FA', 'EU', '4', 'DL', 'ED', '15', 'ER', 'AP', 'DS', 'BQ', 'AF', 'DS', 'BQ', 'AF', '2', 'EQ', 'DP', 'AP', 'BM', 'AF', 'BM', 'AF']",['64']
345,3,404,417,13,0,34,"['EY', '1', 'AA', '7', 'EQ', 'AP', 'BR', 'AF', 'BM', 'AF', '1', 'AD', 'FA', 'EU', '4', 'DL', 'ED', '15', 'ER', 'AP', 'DS', 'BQ', 'AF', 'DS', 'BQ', 'AF', '2', 'EQ', 'DP', 'AP', 'BM', 'AF', 'BM', 'AF']",['93']
346,3,404,422,18,0,33,"['EY', 'EU', '4', 'DL', 'ED', '15', 'ER', 'AP', 'DS', 'BQ', 'AF', 'DS', 'BQ', 'AF', '2', 'EQ', 'DP', 'AP', 'BM', 'AF', 'BM', 'AF', 'FA', 'AA', '7', 'EQ', 'AP', 'BR', 'AF', 'BM', 'AF', '1', 'AD']",['92']
347,3,404,443,39,0,34,"['EY', '1', 'AA', '7', 'EQ', 'AP', 'BR', 'AF', 'BM', 'AF', '1', 'AD', 'FA', 'EU', '4', 'DL', 'ED', '15', 'ER', 'AP', 'DS', 'BQ', 'AF', 'DS', 'BQ', 'AF', '2', 'EQ', 'DP', 'AP', 'BM', 'AF', 'BM', 'AF']",['133']
348,3,404,476,72,0,32,"['EY', '1', 'AA', '7', 'EQ', 'AP', 'BR', 'AF', 'BM', 'AF', '1', 'AD', 'FA', 'EU', '4', 'DL', 'ED', '15', 'ER', 'AP', 'DS', 'BQ', 'AF', 'DS', 'BQ', 'AF', '2', 'EQ', 'DP', 'AP', 'BM', 'AF']",['193']
349,3,404,431,27,0,34,"['EY', '1', 'AA', '7', 'EQ', 'AP', 'BR', 'AF', 'BM', 'AF', '1', 'AD', 'FA', 'EU', '4', 'DL', 'ED', '15', 'ER', 'AP', 'DS', 'BQ', 'AF', 'DS', 'BQ', 'AF', '2', 'EQ', 'DP', 'AP', 'BM', 'AF', 'BM', 'AF']",['291']
350,8,405,578,173,0,34,"['EY', '1', 'AA', '7', 'EQ', 'AP', 'BR', 'AF', 'BM', 'AF', '1', 'AD', 'FA', 'EU', '4', 'DL', 'ED', '15', 'ER', 'AP', 'DS', 'BQ', 'AF', 'DS', 'BQ', 'AF', '2', 'EQ', 'DP', 'AP', 'BM', 'AF', 'BM', 'AF']",['294']
351,8,405,606,201,0,31,"['EY', '1', 'AA', 'BR', 'AF', 'BM', 'AF', '1', 'AD', 'FA', 'EU', '4', 'DL', 'ED', '15', 'ER', 'AP', 'DS', 'BQ', 'AF', 'DS', 'BQ', 'AF', '2', 'EQ', 'DP', 'AP', 'BM', 'AF', 'BM', 'AF']",['293']
352,7,406,662,256,227,34,"['EY', '1', 'AA', 'AF', '1', 'AD', 'BR', 'AF', 'BM', '7', 'EQ', 'AP', 'FA', 'EU', '4', 'DL', 'ED', '15', 'ER', 'AP', 'DS', 'BQ', 'AF', 'DS', 'BQ', 'AF', '2', 'EQ', 'DP', 'AP', 'BM', 'AF', 'BM', 'AF']","['312', '85']"
353,7,406,446,40,195,34,"['EY', '1', 'AA', 'AF', '1', 'AD', 'BR', 'AF', 'BM', '7', 'EQ', 'AP', 'FA', 'EU', '4', 'DL', 'ED', '15', 'ER', 'AP', 'DS', 'BQ', 'AF', 'DS', 'BQ', 'AF', '2', 'EQ', 'DP', 'AP', 'BM', 'AF', 'BM', 'AF']","['116', '311']"
354,9,407,497,90,0,34,"['EY', '1', 'AA', 'AF', '1', 'AD', 'BR', 'AF', 'BM', '7', 'EQ', 'AP', 'FA', 'EU', '4', 'DL', 'ED', '15', 'ER', 'AP', 'DS', 'BQ', 'AF', 'DS', 'BQ', 'AF', '2', 'EQ', 'DP', 'AP', 'BM', 'AF', 'BM', 'AF']",['299']
355,15,407,421,14,0,34,"['EY', '1', 'AA', '7', 'EQ', 'AP', 'BR', 'AF', 'BM', 'AF', '1', 'AD', 'FA', 'EU', '4', 'DL', 'ED', '15', 'ER', 'AP', 'DS', 'BQ', 'AF', 'DS', 'BQ', 'AF', '2', 'EQ', 'DP', 'AP', 'BM', 'AF', 'BM', 'AF']",['298']
356,8,408,409,1,0,34,"['EY', '1', 'AA', '7', 'EQ', 'AP', 'BR', 'AF', 'BM', 'AF', '1', 'AD', 'FA', 'EU', '4', 'DL', 'ED', '15', 'ER', 'AP', 'DS', 'BQ', 'AF', 'DS', 'BQ', 'AF', '2', 'EQ', 'DP', 'AP', 'BM', 'AF', 'BM', 'AF']",['96']
357,8,408,498,90,0,37,"['EY', '1', 'AA', '7', 'EQ', 'AP', 'BR', 'AF', 'BM', 'AF', '1', 'AD', 'AF', 'BM', 'AF', 'FA', 'EU', '4', 'DL', 'ED', '15', 'ER', 'AP', 'DS', 'BQ', 'AF', 'DS', 'BQ', 'AF', '2', 'EQ', 'DP', 'AP', 'BM', 'AF', 'BM', 'AF']",['139']
358,8,408,475,67,0,35,"['EY', '1', 'AA', '7', 'EQ', 'AP', 'BR', 'AF', 'BM', 'AF', '1', 'AD', 'FA', 'EU', '4', 'DL', 'ED', '15', 'ER', 'AP', 'DS', 'BQ', 'AF', 'DS', 'BQ', 'AF', '2', 'EQ', 'DP', 'AP', 'BM', 'AF', 'BM', 'AF', 'FB']",['203']
359,11,408,579,171,-83,34,"['EY', '1', 'AA', 'AF', '1', 'AD', 'BR', 'AF', 'BM', '7', 'EQ', 'AP', 'FA', 'EU', '4', 'DL', 'ED', '15', 'ER', 'AP', 'DS', 'BQ', 'AF', 'DS', 'BQ', 'AF', '2', 'EQ', 'DP', 'AP', 'BM', 'AF', 'BM', 'AF']","['227', '310']"
360,8,408,517,109,0,34,"['EY', '1', 'AA', '7', 'EQ', 'AP', 'BR', 'AF', 'BM', 'AF', '1', 'AD', 'FA', 'EU', '4', 'DL', 'ED', '15', 'ER', 'AP', 'DS', 'BQ', 'AF', 'DS', 'BQ', 'AF', '2', 'EQ', 'DP', 'AP', 'BM', 'AQ', 'BK', 'AI']",['309']
361,8,408,455,47,0,34,"['EY', '1', 'AA', '7', 'EQ', 'AP', 'BR', 'AF', 'BM', 'AF', '1', 'AD', 'FA', 'EU', '4', 'DL', 'ED', '15', 'ER', 'AP', 'DS', 'BQ', 'AF', 'DS', 'BQ', 'AF', '2', 'EQ', 'DP', 'AP', 'BM', 'AF', 'BM', 'AF']",['307']
362,8,408,480,72,0,34,"['EY', '1', 'AA', '7', 'EQ', 'AP', 'BR', 'AF', 'BM', 'AF', '1', 'AD', 'FA', 'EU', '4', 'DL', 'ED', '15', 'ER', 'AP', 'DS', 'BQ', 'AF', 'DS', 'BQ', 'AF', '2', 'EQ', 'DP', 'AP', 'BM', 'AF', 'BM', 'AF']",['306']
363,8,408,547,139,0,34,"['EY', '1', 'AA', '7', 'EQ', 'AP', 'BR', 'AF', 'BM', 'AF', '1', 'AD', 'FA', 'EU', '4', 'DL', 'ED', '15', 'ER', 'AP', 'DS', 'BQ', 'AF', 'DS', 'BQ', 'AF', '2', 'EQ', 'DP', 'AP', 'BM', 'DK', 'BT', 'AF']",['305']
364,8,408,427,19,0,34,"['EY', '1', 'AA', '7', 'EQ', 'AP', 'BR', 'AF', 'EI', 'EO', '-2', 'AE', 'FA', 'EU', '4', 'DL', 'ED', '15', 'ER', 'AP', 'DS', 'BQ', 'AF', 'DS', 'BQ', 'AF', '2', 'EQ', 'DP', 'AP', 'BM', 'AF', 'BM', 'AF']",['304']
365,8,408,409,1,0,34,"['EY', '1', 'AA', '7', 'EQ', 'AP', 'BR', 'AF', 'BM', 'AF', '1', 'AD', 'FA', 'EU', '4', 'DL', 'ED', '15', 'ER', 'AP', 'DS', 'BQ', 'AF', 'DS', 'BQ', 'AF', '2', 'EQ', 'DP', 'AP', 'BM', 'AF', 'BM', 'AF']",['303']
366,8,408,522,114,0,34,"['EY', '1', 'AA', '7', 'EQ', 'AP', 'BR', 'AF', 'BM', 'AF', '1', 'AD', 'FA', 'EU', '4', 'DL', 'ED', '15', 'ER', 'AP', 'DS', 'BQ', 'AF', 'DS', 'BQ', 'AF', '2', 'EQ', 'DP', 'AP', 'BM', 'AF', 'BM', 'AF']",['302']
367,8,408,422,14,0,34,"['EY', '1', 'AA', '7', 'EQ', 'AP', 'BR', 'AF', 'BM', 'AF', '1', 'AD', 'FA', 'EU', '4', 'DL', 'ED', '15', 'ER', 'AP', 'DS', 'BQ', 'AF', 'DS', 'BQ', 'AF', '2', 'EQ', 'DP', 'AP', 'BM', 'AF', 'BM', 'AF']",['301']
368,8,408,790,382,0,34,"['EY', '1', 'AA', '7', 'EQ', 'AP', 'BR', 'AF', 'BM', 'AF', '1', 'AD', 'FA', 'EU', '4', 'DL', 'ED', '15', 'ER', 'AP', 'DS', 'BQ', 'AF', 'DS', 'BQ', 'AF', '2', 'EQ', 'DP', 'AP', 'BM', 'AF', 'BM', 'AF']",['300']
369,7,409,790,381,0,34,"['EY', '1', 'AA', 'AF', '1', 'AD', 'BR', 'AF', 'BM', '7', 'EQ', 'AP', 'FA', 'EU', '4', 'DL', 'ED', '15', 'ER', 'AP', 'DS', 'BQ', 'AF', 'DS', 'BQ', 'AF', '2', 'EQ', 'DP', 'AP', 'BM', 'AF', 'BM', 'AF']",['220']
370,7,409,418,9,0,22,"['EY', 'EU', '2', 'DL', 'ED', '17', 'ER', 'AP', 'DS', 'BQ', 'AF', 'DS', 'BQ', 'AF', '-2', 'EQ', 'DP', 'AP', 'BM', 'AF', 'BM', 'AF']",['219']
371,7,409,473,64,0,34,"['EY', '1', 'AA', 'AF', '1', 'AD', 'BR', 'AF', 'BM', '7', 'EQ', 'AP', 'FA', 'EU', '4', 'DL', 'ED', '15', 'ER', 'AP', 'DS', 'BQ', 'AF', 'DS', 'BQ', 'AF', '2', 'EQ', 'DP', 'AP', 'BM', 'AF', 'BM', 'AF']",['313']
372,9,410,460,50,0,34,"['EY', '1', 'AA', 'AF', '1', 'AD', 'BR', 'AF', 'BM', '7', 'EQ', 'AP', 'FA', 'EU', '4', 'DL', 'ED', '15', 'ER', 'AP', 'DS', 'BQ', 'AF', 'DS', 'BQ', 'AF', '2', 'EQ', 'DP', 'AP', 'BM', 'AF', 'BM', 'AF']",['164']
373,9,410,659,249,0,38,"['EY', '1', 'AA', 'AF', '1', 'AD', 'BR', 'AF', 'BM', '7', 'EQ', 'AP', 'FA', 'EU', '4', 'DL', 'ED', '15', 'ER', 'AP', 'DS', 'BQ', 'AF', 'DS', 'BQ', 'AF', '2', 'EQ', 'DP', 'AP', 'BM', 'AF', 'BM', 'AF', 'FB', '54', '-39', 'AD']",['221']
374,9,410,553,143,0,35,"['EY', '1', 'AA', 'AF', '1', 'AD', 'BR', 'AF', 'BM', '41', '7', 'EQ', 'AP', 'FA', 'EU', '4', 'DL', 'ED', '15', 'ER', 'AP', 'DS', 'BQ', 'AF', 'DS', 'BQ', 'AF', '2', 'EQ', 'DP', 'AP', 'BM', 'AF', 'BM', 'AF']",['317']
375,9,410,444,34,0,33,"['EY', '1', 'AA', 'AF', '1', 'BR', 'AF', 'BM', '7', 'EQ', 'AP', 'FA', 'EU', '4', 'DL', 'ED', '15', 'ER', 'AP', 'DS', 'BQ', 'AF', 'DS', 'BQ', 'AF', '2', 'EQ', 'DP', 'AP', 'BM', 'AF', 'BM', 'AF']",['314']
376,6,410,494,84,116,34,"['EY', '1', 'AA', '7', 'EQ', 'AP', 'BR', 'AF', 'BM', 'AF', '1', 'AD', 'FA', 'EU', '4', 'DL', 'ED', '15', 'ER', 'AP', 'DS', 'BQ', 'AF', 'DS', 'BQ', 'AF', '2', 'EQ', 'DP', 'AP', 'BM', 'AF', 'BM', 'AF']","['328', '212']"
377,11,411,489,78,0,34,"['EY', '1', 'AA', 'AF', '1', 'AD', 'BR', 'AF', 'BM', '7', 'EQ', 'AP', 'FA', 'EU', '4', 'DL', 'ED', '15', 'ER', 'AP', 'DS', 'BQ', 'AF', 'DS', 'BQ', 'AF', '2', 'EQ', 'DP', 'AP', 'BM', 'AF', 'BM', 'AF']",['320']
378,11,411,585,174,0,38,"['EY', '1', 'AA', 'AF', '1', 'AD', 'BR', 'AF', 'BM', '7', 'EQ', 'AP', 'FA', 'EU', '4', 'DL', 'ED', '15', 'ER', 'AP', 'DS', 'BQ', 'AF', 'DS', 'BQ', 'AF', '2', 'EQ', 'DP', 'AP', 'BM', 'AF', 'BM', 'AF', 'FB', '54', '-39', 'AD']",['319']
379,13,412,421,9,0,34,"['EY', '1', 'AA', '7', 'EQ', 'AP', 'BR', 'AF', 'BM', 'AF', '1', 'AD', 'FA', 'EU', '4', 'DL', 'ED', '15', 'ER', 'AP', 'DS', 'BQ', 'AF', 'DS', 'BQ', 'AF', '2', 'EQ', 'DP', 'AP', 'BM', 'AF', 'BM', 'AF']",['67']
380,13,412,426,14,0,34,"['EY', '1', 'AA', '7', 'EQ', 'AP', 'BR', 'AF', 'BM', 'AF', '1', 'AD', 'FA', 'EU', '4', 'DL', 'ED', '15', 'ER', 'AP', 'DS', 'BQ', 'AF', 'DS', 'BQ', 'AF', '2', 'EQ', 'DP', 'AP', 'BM', 'AF', 'BM', 'AF']",['99']
381,13,412,440,28,0,34,"['EY', '1', 'AA', '7', 'EQ', 'AP', 'BR', 'AF', 'BM', 'AF', '1', 'AD', 'FA', 'EU', '4', 'DL', 'ED', '15', 'ER', 'AP', 'DS', 'BQ', 'AF', 'DS', 'BQ', 'AF', '2', 'EQ', 'DP', 'AP', 'BM', 'AF', 'BM', 'AF']",['323']
382,13,412,459,47,0,34,"['EY', '1', 'AA', '7', 'EQ', 'AP', 'BR', 'AF', 'BM', 'AF', '1', 'AD', 'FA', 'EU', '4', 'DL', 'ED', '15', 'ER', 'AP', 'DS', 'BQ', 'AF', 'DS', 'BQ', 'AF', '2', 'EQ', 'DP', 'AP', 'BM', 'AF', 'BM', 'AF']",['321']
383,6,413,720,307,0,34,"['EY', '1', 'AA', '7', 'EQ', 'AP', 'BR', 'AF', 'BM', 'AF', '1', 'AD', 'FA', 'EU', '4', 'DL', 'ED', '15', 'ER', 'AP', 'DS', 'BQ', 'AF', 'DS', 'BQ', 'AF', '2', 'EQ', 'DP', 'AP', 'BM', 'AF', 'BM', 'AF']",['44']
384,6,413,427,14,0,12,"['EY', '1', 'AA', '7', 'EQ', 'AP', 'BR', 'AF', 'BM', 'AF', '1', 'AD']",['100']
385,6,413,453,40,0,34,"['EY', '1', 'AA', '7', 'EQ', 'AP', 'BR', 'AF', 'BM', 'AF', '1', 'AD', 'FA', 'EU', '4', 'DL', 'ED', '15', 'ER', 'AP', 'DS', 'BQ', 'AF', 'DS', 'BQ', 'AF', '2', 'EQ', 'DP', 'AP', 'BM', 'AF', 'BM', 'AF']",['148']
386,6,413,570,157,0,34,"['EY', '1', 'AA', '7', 'EQ', 'AP', 'BR', 'AF', 'BM', 'AF', '1', 'AD', 'FA', 'EU', '4', 'DL', 'ED', '15', 'ER', 'AP', 'DS', 'BQ', 'AF', 'DS', 'BQ', 'AF', '2', 'EQ', 'DP', 'AP', 'BM', 'AF', 'BM', 'AF']",['214']
387,6,413,447,34,0,33,"['EY', '1', 'AA', '7', 'EQ', 'AP', 'BR', 'AF', 'BM', 'AF', '1', 'FA', 'EU', '4', 'DL', 'ED', '15', 'ER', 'AP', 'DS', 'BQ', 'AF', 'DS', 'BQ', 'AF', '2', 'EQ', 'DP', 'AP', 'BM', 'AF', 'BM', 'AF']",['213']
388,6,413,456,43,0,34,"['EY', '1', 'AA', '7', 'EQ', 'AP', 'BR', 'AF', 'BM', 'AF', '1', 'AD', 'FA', 'EU', '4', 'DL', 'ED', '15', 'ER', 'AP', 'DS', 'BQ', 'AF', 'DS', 'BQ', 'AF', '2', 'EQ', 'DP', 'AP', 'BM', 'AF', 'BM', 'AF']",['206']
389,6,413,420,7,0,34,"['EY', '1', 'AA', '7', 'BF', 'DZ', 'AD', 'DM', 'BM', 'AF', '1', 'AD', 'FA', 'EU', '4', 'DL', 'ED', '15', 'ER', 'AP', 'DS', 'BQ', 'AF', 'DS', 'BQ', 'AF', '2', 'EQ', 'DP', 'AP', 'BM', 'AF', 'BM', 'AF']",['205']
390,6,413,490,77,0,34,"['EY', '1', 'AA', '7', 'EQ', 'AP', 'EP', 'EI', 'BM', 'AF', '1', 'AD', 'FA', 'EU', '4', 'DL', 'ED', '15', 'ER', 'AP', 'DS', 'BQ', 'AF', 'DS', 'BQ', 'AF', '2', 'EQ', 'DP', 'AP', 'BM', 'AF', 'BM', 'AF']",['334']
391,6,413,493,80,0,34,"['EY', '1', 'AA', '7', 'EQ', 'AP', 'BR', 'AF', 'BM', 'AF', '1', 'AD', 'FA', 'EU', '4', 'DL', 'ED', '15', 'ER', 'AP', 'DS', 'BQ', 'AF', 'DS', 'BQ', 'AF', '2', 'EQ', 'DP', 'AP', 'BM', 'AF', 'BM', 'AF']",['331']
392,6,413,489,76,0,34,"['EY', '1', 'AA', '7', 'EQ', 'AP', 'BR', 'AF', 'BM', 'AF', '1', 'AD', 'FA', 'EU', '4', 'DL', 'ED', '15', 'ER', 'AP', 'DS', 'BQ', 'AF', 'DS', 'BQ', 'AF', '2', 'EQ', 'DP', 'AP', 'BM', 'AF', 'BM', 'AF']",['330']
393,6,413,491,78,0,34,"['EY', '1', 'AA', '7', 'EQ', 'AP', 'BR', 'AF', 'BM', 'AF', '1', 'AD', 'FA', 'EU', '4', 'DL', 'ED', '15', 'ER', 'AP', 'DS', 'BQ', 'AF', 'DS', 'BQ', 'AF', '2', 'EQ', 'DP', 'AP', 'BM', 'AF', 'BM', 'AF']",['329']
394,6,413,427,14,0,34,"['EY', '1', 'AA', '7', 'EQ', 'AP', 'BR', 'AF', 'BM', 'AF', '1', 'AD', 'FA', 'EU', '4', 'DL', 'ED', '15', 'ER', 'AP', 'DS', 'BQ', 'AF', 'DS', 'BQ', 'AF', '2', 'EQ', 'DP', 'AP', 'BM', 'AF', 'BM', 'AF']",['325']
395,11,414,736,322,0,34,"['EY', '1', 'AA', '7', 'EQ', 'AP', 'BR', 'AF', 'BM', 'AF', '1', 'AD', 'FA', 'EU', '4', 'DL', 'ED', '15', 'ER', 'AP', 'DS', 'BQ', 'AF', 'DS', 'BQ', 'AF', '2', 'EQ', 'DP', 'AP', 'BM', 'AF', 'BM', 'AF']",['336']
396,4,416,436,20,0,33,"['EY', 'EU', '4', 'DL', 'ED', '15', 'ER', 'AP', 'DS', 'BQ', 'AF', 'DS', 'BQ', 'AF', '2', 'EQ', 'DP', 'AP', 'BM', 'AF', 'BM', 'AF', 'FA', 'AA', '7', 'EQ', 'AP', 'BR', 'AF', 'BM', 'AF', '1', 'AD']",['346']
397,11,417,454,37,0,34,"['EY', '1', 'AA', '7', 'EQ', 'AP', 'BR', 'AF', 'BM', 'AF', '1', 'AD', 'FA', 'EU', '4', 'DL', 'ED', '15', 'ER', 'AP', 'DS', 'BQ', 'AF', 'DS', 'BQ', 'AF', '2', 'EQ', 'DP', 'AP', 'BM', 'AF', 'BM', 'AF']",['150']
398,11,417,592,175,0,37,"['EY', '1', 'AA', '7', 'EQ', 'AP', 'BR', 'AF', 'BM', 'AF', '1', 'AD', 'AF', 'BM', 'AF', 'FA', 'EU', '4', 'DL', 'ED', '15', 'ER', 'AP', 'DS', 'BQ', 'AF', 'DS', 'BQ', 'AF', '2', 'EQ', 'DP', 'AP', 'BM', 'AF', 'BM', 'AF']",['226']
399,11,417,431,14,0,32,"['EY', '1', 'AA', '7', 'EQ', 'AP', 'BR', 'AF', 'BM', 'AF', '1', 'AD', 'FA', 'EU', '6', 'EV', 'ED', '15', 'ER', 'AP', 'DS', 'BQ', 'AF', 'DS', 'BQ', 'AF', '2', 'AP', 'BM', 'AF', 'BM', 'AF']",['342']
400,11,417,422,5,0,35,"['EY', '1', 'AA', '7', 'EQ', 'AP', 'BR', 'AF', 'BM', 'AF', '1', 'AD', 'FA', 'EU', '4', 'DL', 'ED', '15', 'ER', 'AP', 'DS', 'BQ', 'AF', 'DS', 'BQ', 'AF', '2', 'EQ', 'DP', 'AP', 'BM', 'AF', 'BM', 'AF', 'FB']",['340']
401,11,417,422,5,0,34,"['EY', '1', 'AA', '7', 'EQ', 'AP', 'BR', 'AF', 'BM', 'AF', '1', 'AD', 'FA', 'EU', '4', 'DL', 'ED', '15', 'ER', 'AP', 'DS', 'BQ', 'AF', 'DS', 'BQ', 'AF', '2', 'EQ', 'DP', 'AP', 'BM', 'AF', 'BM', 'AF']",['338']
402,11,417,464,47,0,34,"['EY', '1', 'AA', '7', 'EQ', 'AP', 'BR', 'AF', 'BM', 'AF', '1', 'AD', 'FA', 'EU', '4', 'DL', 'ED', '15', 'ER', 'AP', 'DS', 'BQ', 'AF', 'DS', 'BQ', 'AF', '2', 'EQ', 'DP', 'AP', 'BM', 'AF', 'BM', 'AF']",['337']
403,4,418,621,203,0,32,"['EY', '7', 'EQ', 'AP', 'BR', 'AF', 'BM', 'AF', '1', 'AD', 'FA', 'EU', '4', 'DL', 'ED', '15', 'ER', 'AP', 'DS', 'BQ', 'AF', 'DS', 'BQ', 'AF', '2', 'EQ', 'DP', 'AP', 'BM', 'AF', 'BM', 'AF']",['29']
404,4,418,583,165,0,34,"['EY', '1', 'AA', '7', 'EQ', 'AP', 'BR', 'AF', 'BM', 'AF', '1', 'AD', 'FA', 'EU', '4', 'DL', 'ED', '15', 'ER', 'AP', 'DS', 'BQ', 'AF', 'DS', 'BQ', 'AF', '2', 'EQ', 'DP', 'AP', 'BM', 'AF', 'BM', 'AF']",['72']
405,4,418,461,43,0,34,"['EY', '1', 'AA', '7', 'EQ', 'AP', 'BR', 'AF', 'BM', 'AF', '1', 'AD', 'FA', 'EU', '4', 'DL', 'ED', '15', 'ER', 'AP', 'DS', 'BQ', 'AF', 'DS', 'BQ', 'AF', '2', 'EQ', 'DP', 'AP', 'BM', 'AF', 'BM', 'AF']",['71']
406,4,418,441,23,0,34,"['EY', '1', 'AA', '7', 'EQ', 'AP', 'BR', 'AF', 'BM', 'AF', '1', 'AD', 'FA', 'EU', '4', 'DL', 'ED', '15', 'ER', 'AP', 'DS', 'BQ', 'AF', 'DS', 'BQ', 'AF', '2', 'EQ', 'DP', 'AP', 'BM', 'AF', 'BM', 'AF']",['151']
407,4,418,443,25,0,34,"['EY', '1', 'AA', '7', 'EQ', 'AP', 'BR', 'AF', 'BM', 'AF', '1', 'AD', 'FA', 'EU', '4', 'DL', 'ED', '15', 'ER', 'AP', 'DS', 'BQ', 'AF', 'DS', 'BQ', 'AF', '2', 'EQ', 'DP', 'AP', 'BM', 'AF', 'BM', 'AF']",['236']
408,4,418,431,13,0,33,"['EY', '1', 'AA', '7', 'EQ', 'AP', 'BR', 'AF', 'BM', 'AF', '1', 'AD', 'FA', 'EU', 'DL', 'ED', '15', 'ER', 'AP', 'DS', 'BQ', 'AF', 'DS', 'BQ', 'AF', '2', 'EQ', 'DP', 'AP', 'BM', 'AF', 'BM', 'AF']",['235']
409,4,418,427,9,0,34,"['EY', '1', 'AA', '7', 'EQ', 'AP', 'BR', 'AF', 'BM', 'AF', '1', 'AD', 'FA', 'EU', '4', 'DL', 'ED', '15', 'ER', 'AP', 'DS', 'BQ', 'AF', 'DS', 'BQ', 'AF', '2', 'EQ', 'DP', 'AP', 'BM', 'AF', 'BM', 'AF']",['231']
410,4,418,445,27,0,34,"['EY', '1', 'AA', '7', 'EQ', 'AP', 'BR', 'AF', 'BM', 'AF', '1', 'AD', 'FA', 'EU', '4', 'DL', 'ED', '15', 'ER', 'AP', 'DS', 'BQ', 'AF', 'DS', 'BQ', 'AF', '2', 'EQ', 'DP', 'AP', 'BM', 'AF', 'BM', 'AF']",['230']
411,4,418,484,66,0,34,"['EY', '1', 'AA', '7', 'EQ', 'AP', 'BR', 'AF', 'BM', 'AF', '1', 'AD', 'FA', 'EU', '4', 'DL', 'ED', '15', 'ER', 'AP', 'DS', 'BQ', 'AF', 'DS', 'BQ', 'AF', '2', 'EQ', 'DP', 'AP', 'BM', 'AF', 'BM', 'AF']",['349']
412,4,418,805,387,0,32,"['EY', '1', 'AA', '7', 'EQ', 'AP', 'BR', 'AF', 'BM', 'AF', '1', 'AD', 'FA', 'EU', '4', 'DL', 'ED', '15', 'ER', 'AP', 'DS', 'BQ', 'AF', 'DS', 'BQ', 'AF', '2', 'EQ', 'DP', 'AP', 'BM', 'AF']",['348']
413,4,418,487,69,0,30,"['EY', '1', 'AA', '7', 'EQ', 'AP', 'BR', 'AF', 'BM', 'AF', '1', 'AD', 'FA', 'EU', '4', 'DL', 'ED', '15', 'ER', 'AP', 'DS', 'BQ', 'AF', 'EQ', 'DP', 'AP', 'BM', 'AF', 'BM', 'AF']",['347']
414,4,418,432,14,0,34,"['EY', '1', 'AA', '7', 'EQ', 'AP', 'BR', 'AF', 'BM', 'AF', '1', 'AD', 'FA', 'EU', '4', 'DL', 'ED', '15', 'ER', 'AP', 'DS', 'BQ', 'AF', 'DS', 'BQ', 'AF', '2', 'EQ', 'DP', 'AP', 'BM', 'AF', 'BM', 'AF']",['343']
415,9,419,441,22,0,31,"['EY', '1', 'AA', 'BR', 'AF', 'BM', 'AF', '1', 'AD', 'FA', 'EU', '4', 'DL', 'ED', '15', 'ER', 'AP', 'DS', 'BQ', 'AF', 'DS', 'BQ', 'AF', '2', 'EQ', 'DP', 'AP', 'BM', 'AF', 'BM', 'AF']",['243']
416,9,419,597,178,0,31,"['EY', '1', 'AA', 'BR', 'AF', 'BM', 'AF', '1', 'AD', 'FA', 'EU', '4', 'DL', 'ED', '15', 'ER', 'AP', 'DS', 'BQ', 'AF', 'DS', 'BQ', 'AF', '2', 'EQ', 'DP', 'AP', 'BM', 'AF', 'BM', 'AF']",['351']
417,9,419,487,68,0,34,"['EY', '1', 'AA', '7', 'EQ', 'AP', 'BR', 'AF', 'BM', 'AF', '1', 'AD', 'FA', 'EU', '4', 'DL', 'ED', '15', 'ER', 'AP', 'DS', 'BQ', 'AF', 'DS', 'BQ', 'AF', '2', 'EQ', 'DP', 'AP', 'BM', 'AF', 'BM', 'AF']",['350']
418,8,420,919,499,0,34,"['EY', '1', 'AA', 'AF', '1', 'AD', 'BR', 'AF', 'BM', '7', 'EQ', 'AP', 'FA', 'EU', '4', 'DL', 'ED', '15', 'ER', 'AP', 'DS', 'BQ', 'AF', 'DS', 'BQ', 'AF', '2', 'EQ', 'DP', 'AP', 'BM', 'AF', 'BM', 'AF']",['353']
419,8,420,599,179,0,34,"['EY', '1', 'AA', 'AF', '1', 'AD', 'BR', 'AF', 'BM', '7', 'EQ', 'AP', 'FA', 'EU', '4', 'DL', 'ED', '15', 'ER', 'AP', 'DS', 'BQ', 'AF', 'DS', 'BQ', 'AF', '2', 'EQ', 'DP', 'AP', 'BM', 'AF', 'BM', 'AF']",['352']
420,7,421,424,3,0,31,"['EY', '1', 'AA', 'BR', 'AF', 'BM', 'AF', '1', 'AD', 'FA', 'EU', '4', 'DL', 'ED', '15', 'ER', 'AP', 'DS', 'BQ', 'AF', 'DS', 'BQ', 'AF', '2', 'EQ', 'DP', 'AP', 'BM', 'AF', 'BM', 'AF']",['174']
421,10,421,698,277,-98,38,"['EY', '1', 'AA', 'AF', '1', 'AD', 'BR', 'AF', 'BM', '7', 'EQ', 'AP', 'FA', 'EU', '4', 'DL', 'ED', '15', 'ER', 'AP', 'DS', 'BQ', 'AF', 'DS', 'BQ', 'AF', '2', 'EQ', 'DP', 'AP', 'BM', 'AF', 'BM', 'AF', 'FB', '54', '-39', 'AD']","['369', '271']"
422,10,421,475,54,0,34,"['EY', '1', 'AA', 'AF', '1', 'AD', 'BR', 'AF', 'BM', '7', 'EQ', 'AP', 'FA', 'EU', '4', 'DL', 'ED', '15', 'ER', 'AP', 'DS', 'BQ', 'AF', 'DS', 'BQ', 'AF', '2', 'EQ', 'DP', 'AP', 'BM', 'AF', 'BM', 'AF']",['354']
423,10,421,630,209,188,38,"['EY', '1', 'AA', 'AF', '1', 'AD', 'BR', 'AF', 'BM', '7', 'EQ', 'AP', 'FA', 'EU', '4', 'DL', 'ED', '15', 'ER', 'AP', 'DS', 'BQ', 'AF', 'DS', 'BQ', 'AF', '2', 'EQ', 'DP', 'AP', 'BM', 'AF', 'BM', 'AF', 'FB', '54', '-39', 'AD']","['185', '373']"
424,10,421,541,120,102,34,"['EY', '1', 'AA', 'AF', '1', 'AD', 'BR', 'AF', 'BM', '7', 'EQ', 'AP', 'FA', 'EU', '4', 'DL', 'ED', '15', 'ER', 'AP', 'DS', 'BQ', 'AF', 'DS', 'BQ', 'AF', '2', 'EQ', 'DP', 'AP', 'BM', 'AF', 'BM', 'AF']","['372', '270']"
425,6,422,432,10,0,34,"['EY', '1', 'AA', 'AF', '1', 'AD', 'BR', 'AF', 'BM', '7', 'EQ', 'AP', 'FA', 'EU', '4', 'DL', 'ED', '15', 'ER', 'AP', 'DS', 'BQ', 'AF', 'DS', 'BQ', 'AF', '2', 'EQ', 'DP', 'AP', 'BM', 'AF', 'BM', 'AF']",['102']
426,9,422,470,48,0,34,"['EY', '1', 'AA', '7', 'EQ', 'AP', 'BR', 'AF', 'BM', 'AF', '1', 'AD', 'FA', 'EU', '4', 'DL', 'ED', '15', 'ER', 'AP', 'DS', 'BQ', 'AF', 'DS', 'BQ', 'AF', '2', 'EQ', 'DP', 'AP', 'BM', 'AF', 'BM', 'AF']",['162']
427,9,422,550,128,0,34,"['EY', '1', 'AA', '7', 'EQ', 'AP', 'BR', 'AF', 'BM', 'AF', '1', 'AD', 'FA', 'EU', '4', 'DL', 'ED', '15', 'ER', 'AP', 'DS', 'BQ', 'AF', 'DS', 'BQ', 'AF', '2', 'EQ', 'DP', 'AP', 'BM', 'AF', 'BM', 'AF']",['244']
428,9,422,436,14,0,35,"['EY', '1', 'AA', '7', 'EQ', 'AP', 'BR', 'AF', 'BM', 'AF', '1', 'AD', 'FA', 'EU', '4', 'DL', 'ED', '15', 'ER', 'AP', 'DS', 'BQ', 'AF', 'DS', 'BQ', 'AF', '2', 'EQ', 'DP', 'AP', 'BM', 'AF', 'BM', 'AF', 'FB']",['242']
429,9,422,436,14,0,34,"['EY', '1', 'AA', '7', 'EQ', 'AP', 'BR', 'AF', 'BM', 'AF', '1', 'AD', 'FA', 'EU', '4', 'DL', 'ED', '15', 'ER', 'AP', 'DS', 'BQ', 'AF', 'DS', 'BQ', 'AF', '2', 'EQ', 'DP', 'AP', 'BM', 'AF', 'BM', 'AF']",['368']
430,9,422,446,24,0,12,"['EY', '1', 'AA', '7', 'EQ', 'AP', 'BR', 'AF', 'BM', 'AF', '1', 'AD']",['366']
431,9,422,457,35,0,34,"['EY', '1', 'AA', '7', 'EQ', 'AP', 'BR', 'AF', 'EI', 'EO', '-2', 'AE', 'FA', 'EU', '4', 'DL', 'ED', '15', 'ER', 'AP', 'DS', 'BQ', 'AF', 'DS', 'BQ', 'AF', '2', 'EQ', 'DP', 'AP', 'BM', 'AF', 'BM', 'AF']",['364']
432,9,422,432,10,0,34,"['EY', '1', 'AA', '7', 'EQ', 'AP', 'BR', 'AF', 'BM', 'AF', '1', 'AD', 'FA', 'EU', '4', 'DL', 'ED', '15', 'ER', 'AP', 'DS', 'BQ', 'AF', 'DS', 'BQ', 'AF', '2', 'EQ', 'DP', 'AP', 'BM', 'AF', 'BM', 'AF']",['362']
433,9,422,479,57,0,34,"['EY', '1', 'AA', '7', 'EQ', 'AP', 'BR', 'AF', 'BM', 'AF', '1', 'AD', 'FA', 'EU', '4', 'DL', 'ED', '15', 'ER', 'AP', 'DS', 'BQ', 'AF', 'DS', 'BQ', 'AF', '2', 'EQ', 'DP', 'AP', 'BM', 'AF', 'BM', 'AF']",['361']
434,9,422,451,29,0,34,"['EY', '1', 'AA', '7', 'EQ', 'AP', 'BR', 'AF', 'BM', 'AF', '1', 'AD', 'FA', 'EU', '4', 'DL', 'ED', '15', 'ER', 'AP', 'DS', 'BQ', 'AF', 'DS', 'BQ', 'AF', '2', 'EQ', 'DP', 'AP', 'BM', 'AQ', 'BK', 'AI']",['360']
435,12,422,606,184,86,34,"['EY', '1', 'AA', 'AF', '1', 'AD', 'BR', 'AF', 'BM', '7', 'EQ', 'AP', 'FA', 'EU', '4', 'DL', 'ED', '15', 'ER', 'AP', 'DS', 'BQ', 'AF', 'DS', 'BQ', 'AF', '2', 'EQ', 'DP', 'AP', 'BM', 'AF', 'BM', 'AF']","['273', '359']"
436,9,422,458,36,0,35,"['EY', '1', 'AA', '7', 'EQ', 'AP', 'BR', 'AF', 'BM', 'AF', '1', 'AD', 'FA', 'EU', '4', 'DL', 'ED', '15', 'ER', 'AP', 'DS', 'BQ', 'AF', 'DS', 'BQ', 'AF', '2', 'EQ', 'DP', 'AP', 'BM', 'AF', 'BM', 'AF', 'FB']",['358']
437,9,422,469,47,0,37,"['EY', '1', 'AA', '7', 'EQ', 'AP', 'BR', 'AF', 'BM', 'AF', '1', 'AD', 'AF', 'BM', 'AF', 'FA', 'EU', '4', 'DL', 'ED', '15', 'ER', 'AP', 'DS', 'BQ', 'AF', 'DS', 'BQ', 'AF', '2', 'EQ', 'DP', 'AP', 'BM', 'AF', 'BM', 'AF']",['357']
438,2,423,436,13,0,12,"['EY', '1', 'AA', '7', 'EQ', 'AP', 'BR', 'AF', 'BM', 'AF', '1', 'AD']",['11']
439,8,423,545,122,0,34,"['EY', '1', 'AA', 'AF', 'EQ', 'AP', 'BR', 'AF', 'BM', '7', '1', 'AD', 'FA', 'EU', '4', 'DL', 'ED', '15', 'ER', 'AP', 'DS', 'BQ', 'AF', 'DS', 'BQ', 'AF', '2', 'EQ', 'DP', 'AP', 'BM', 'AF', 'BM', 'AF']",['138']
440,14,423,460,37,0,34,"['EY', '1', 'AA', '7', 'EQ', 'AP', 'BR', 'AF', 'BM', 'AF', '1', 'AD', 'FA', 'EU', '4', 'DL', 'ED', '15', 'ER', 'AP', 'DS', 'BQ', 'AF', 'DS', 'BQ', 'AF', '2', 'EQ', 'DP', 'AP', 'BM', 'AF', 'BM', 'AF']",['245']
441,8,423,590,167,0,34,"['EY', '1', 'AA', 'AF', '1', 'AD', 'BR', 'AF', 'BM', '7', 'EQ', 'AP', 'FA', 'EU', '4', 'DL', 'ED', '15', 'ER', 'AP', 'DS', 'BQ', 'AF', 'DS', 'BQ', 'AF', '2', 'EQ', 'DP', 'AP', 'BM', 'AF', 'BM', 'AF']",['266']
442,8,423,552,129,0,34,"['EY', '1', 'AA', 'AF', '1', 'AD', 'BR', 'AF', 'BM', '7', 'EQ', 'AP', 'FA', 'EU', '4', 'DL', 'ED', '15', 'ER', 'AP', 'DS', 'BQ', 'AF', 'DS', 'BQ', 'AF', '2', 'EQ', 'DP', 'AP', 'BM', 'AF', 'BM', 'AF']",['371']
443,7,424,532,108,0,34,"['EY', '1', 'AA', '7', 'EQ', 'AP', 'BR', 'AF', 'BM', 'AF', '1', 'AD', 'FA', 'EU', '4', 'DL', 'ED', '15', 'ER', 'AP', 'DS', 'BQ', 'AF', 'DS', 'BQ', 'AF', '2', 'EQ', 'DP', 'AP', 'BM', 'AF', 'BM', 'AF']",['247']
444,10,424,458,34,0,33,"['EY', '1', 'AA', 'AF', '1', 'BR', 'AF', 'BM', '7', 'EQ', 'AP', 'FA', 'EU', '4', 'DL', 'ED', '15', 'ER', 'AP', 'DS', 'BQ', 'AF', 'DS', 'BQ', 'AF', '2', 'EQ', 'DP', 'AP', 'BM', 'AF', 'BM', 'AF']",['375']
445,10,424,503,79,0,35,"['EY', '1', 'AA', 'AF', '1', 'AD', 'BR', 'AF', 'BM', '41', '7', 'EQ', 'AP', 'FA', 'EU', '4', 'DL', 'ED', '15', 'ER', 'AP', 'DS', 'BQ', 'AF', 'DS', 'BQ', 'AF', '2', 'EQ', 'DP', 'AP', 'BM', 'AF', 'BM', 'AF']",['374']
446,14,426,587,161,0,34,"['EY', '1', 'AA', '7', 'EQ', 'AP', 'BR', 'AF', 'BM', 'AF', '1', 'AD', 'FA', 'EU', '4', 'DL', 'ED', '15', 'ER', 'AP', 'DS', 'BQ', 'AF', 'DS', 'BQ', 'AF', '2', 'EQ', 'DP', 'AP', 'BM', 'AF', 'BM', 'AF']",['79']
447,14,426,445,19,0,34,"['EY', '1', 'AA', '7', 'EQ', 'AP', 'BR', 'AF', 'BM', 'AF', '1', 'AD', 'FA', 'EU', '4', 'DL', 'ED', '15', 'ER', 'AP', 'DS', 'BQ', 'AF', 'DS', 'BQ', 'AF', '2', 'EQ', 'DP', 'AP', 'BM', 'AF', 'BM', 'AF']",['166']
448,14,426,511,85,0,34,"['EY', '1', 'AA', '7', 'EQ', 'AP', 'BR', 'AF', 'BM', 'AF', '1', 'AD', 'FA', 'EU', '4', 'DL', 'ED', '15', 'ER', 'AP', 'DS', 'BQ', 'AF', 'DS', 'BQ', 'AF', '2', 'EQ', 'DP', 'AP', 'BM', 'AF', 'BM', 'AF']",['382']
449,7,427,512,85,0,34,"['EY', '1', 'AA', '7', 'EQ', 'AP', 'BR', 'AF', 'BM', 'AF', '1', 'AD', 'FA', 'EU', '4', 'DL', 'ED', '15', 'ER', 'AP', 'DS', 'BQ', 'AF', 'DS', 'BQ', 'AF', '2', 'EQ', 'DP', 'AP', 'BM', 'AF', 'BM', 'AF']",['172']
450,7,427,488,61,0,34,"['EY', '1', 'AA', '7', 'EQ', 'AP', 'BR', 'AF', 'BM', 'AF', '1', 'AD', 'FA', 'EU', '4', 'DL', 'ED', '15', 'ER', 'AP', 'DS', 'BQ', 'AF', 'DS', 'BQ', 'AF', '2', 'EQ', 'DP', 'AP', 'BM', 'DK', 'BT', 'AF']",['259']
451,7,427,430,3,0,34,"['EY', '1', 'AA', '7', 'EQ', 'AP', 'BR', 'AF', 'BM', 'AF', '1', 'AD', 'FA', 'EU', '4', 'DL', 'ED', '15', 'ER', 'AP', 'DS', 'BQ', 'AF', 'DS', 'BQ', 'AF', '2', 'EQ', 'DP', 'AP', 'BM', 'AF', 'BM', 'AF']",['257']
452,7,427,517,90,0,34,"['EY', '1', 'AA', '7', 'EQ', 'AP', 'BR', 'AF', 'BM', 'AF', '1', 'AD', 'FA', 'EU', '4', 'DL', 'ED', '15', 'ER', 'AP', 'DS', 'BQ', 'AF', 'DS', 'BQ', 'AF', '2', 'EQ', 'DP', 'AP', 'BM', 'AF', 'BM', 'AF']",['393']
453,7,427,469,42,0,34,"['EY', '1', 'AA', '7', 'EQ', 'AP', 'BR', 'AF', 'BM', 'AF', '1', 'AD', 'FA', 'EU', '4', 'DL', 'ED', '15', 'ER', 'AP', 'DS', 'BQ', 'AF', 'DS', 'BQ', 'AF', '2', 'EQ', 'DP', 'AP', 'BM', 'AF', 'BM', 'AF']",['392']
454,7,427,441,14,0,34,"['EY', '1', 'AA', '7', 'EQ', 'AP', 'BR', 'AF', 'BM', 'AF', '1', 'AD', 'FA', 'EU', '4', 'DL', 'ED', '15', 'ER', 'AP', 'DS', 'BQ', 'AF', 'DS', 'BQ', 'AF', '2', 'EQ', 'DP', 'AP', 'BM', 'AF', 'BM', 'AF']",['391']
455,7,427,478,51,0,34,"['EY', '1', 'AA', '7', 'EQ', 'AP', 'EP', 'EI', 'BM', 'AF', '1', 'AD', 'FA', 'EU', '4', 'DL', 'ED', '15', 'ER', 'AP', 'DS', 'BQ', 'AF', 'DS', 'BQ', 'AF', '2', 'EQ', 'DP', 'AP', 'BM', 'AF', 'BM', 'AF']",['390']
456,7,427,502,75,0,34,"['EY', '1', 'AA', '7', 'EQ', 'AP', 'BR', 'AF', 'BM', 'AF', '1', 'AD', 'FA', 'EU', '4', 'DL', 'ED', '15', 'ER', 'AP', 'DS', 'BQ', 'AF', 'DS', 'BQ', 'AF', '2', 'EQ', 'DP', 'AP', 'BM', 'AF', 'BM', 'AF']",['388']
457,7,427,431,4,0,34,"['EY', '1', 'AA', '7', 'EQ', 'AP', 'BR', 'AF', 'BM', 'AF', '1', 'AD', 'FA', 'EU', '4', 'DL', 'ED', '15', 'ER', 'AP', 'DS', 'BQ', 'AF', 'DS', 'BQ', 'AF', '2', 'EQ', 'DP', 'AP', 'BM', 'AF', 'BM', 'AF']",['386']
458,7,427,560,133,0,34,"['EY', '1', 'AA', '7', 'EQ', 'AP', 'BR', 'AF', 'BM', 'AF', '1', 'AD', 'FA', 'EU', 'AP', 'DS', 'BQ', '15', 'ER', '4', 'DL', 'ED', 'AF', 'DS', 'BQ', 'AF', '2', 'EQ', 'DP', 'AP', 'BM', 'AF', 'BM', 'AF']",['385']
459,7,427,441,14,0,34,"['EY', '1', 'AA', '7', 'EQ', 'AP', 'BR', 'AF', 'BM', 'AF', '1', 'AD', 'FA', 'EU', '4', 'DL', 'ED', '15', 'ER', 'AP', 'DS', 'BQ', 'AF', 'DS', 'BQ', 'AF', '2', 'EQ', 'DP', 'AP', 'BM', 'AF', 'BM', 'AF']",['383']
460,12,428,471,43,0,34,"['EY', '1', 'AA', '7', 'EQ', 'AP', 'BR', 'AF', 'BM', 'AF', '1', 'AD', 'FA', 'EU', '4', 'DL', 'ED', '15', 'ER', 'AP', 'DS', 'BQ', 'AF', 'DS', 'BQ', 'AF', '2', 'EQ', 'DP', 'AP', 'BM', 'AF', 'BM', 'AF']",['395']
461,5,428,451,23,0,33,"['EY', 'EU', '4', 'DL', 'ED', '15', 'ER', 'AP', 'DS', 'BQ', 'AF', 'DS', 'BQ', 'AF', '2', 'EQ', 'DP', 'AP', 'BM', 'AF', 'BM', 'AF', 'FA', 'AA', '7', 'EQ', 'AP', 'BR', 'AF', 'BM', 'AF', '1', 'AD']",['396']
462,5,429,446,17,86,36,"['EY', '1', 'AA', '7', 'EQ', 'AP', 'BR', 'AF', 'BM', 'AF', '1', 'AD', 'FA', 'EU', '4', 'DL', 'ED', 'BM', 'AF', '15', 'ER', 'AP', 'DS', 'BQ', 'AF', 'DS', 'BQ', 'AF', '2', 'EQ', 'DP', 'AP', 'BM', 'AF', 'BM', 'AF']","['267', '181']"
463,12,431,540,109,0,34,"['EY', '1', 'AA', '7', 'EQ', 'AP', 'BR', 'AF', 'BM', 'AF', '1', 'AD', 'FA', 'EU', '4', 'DL', 'ED', '15', 'ER', 'AP', 'DS', 'BQ', 'AF', 'DS', 'BQ', 'AF', '2', 'EQ', 'DP', 'AP', 'BM', 'AF', 'BM', 'AF']",['54']
464,12,431,573,142,0,34,"['EY', '1', 'AA', '7', 'EQ', 'AP', 'BR', 'AF', 'BM', 'AF', '1', 'AD', 'FA', 'EU', '4', 'DL', 'ED', '15', 'ER', 'AP', 'DS', 'BQ', 'AF', 'DS', 'BQ', 'AF', '2', 'EQ', 'DP', 'AP', 'BM', 'AF', 'BM', 'AF']",['272']
465,12,431,564,133,0,34,"['EY', '1', 'AA', '7', 'EQ', 'AP', 'BR', 'AF', 'BM', 'AF', '1', 'AD', 'FA', 'EU', '4', 'DL', 'ED', '15', 'ER', 'AP', 'DS', 'BQ', 'AF', 'DS', 'BQ', 'AF', '2', 'EQ', 'DP', 'AP', 'BM', 'AF', 'BM', 'AF']",['402']
466,12,431,445,14,0,32,"['EY', '1', 'AA', '7', 'EQ', 'AP', 'BR', 'AF', 'BM', 'AF', '1', 'AD', 'FA', 'EU', '6', 'EV', 'ED', '15', 'ER', 'AP', 'DS', 'BQ', 'AF', 'DS', 'BQ', 'AF', '2', 'AP', 'BM', 'AF', 'BM', 'AF']",['399']
467,12,431,474,43,0,37,"['EY', '1', 'AA', '7', 'EQ', 'AP', 'BR', 'AF', 'BM', 'AF', '1', 'AD', 'AF', 'BM', 'AF', 'FA', 'EU', '4', 'DL', 'ED', '15', 'ER', 'AP', 'DS', 'BQ', 'AF', 'DS', 'BQ', 'AF', '2', 'EQ', 'DP', 'AP', 'BM', 'AF', 'BM', 'AF']",['398']
468,12,431,540,109,0,34,"['EY', '1', 'AA', '7', 'EQ', 'AP', 'BR', 'AF', 'BM', 'AF', '1', 'AD', 'FA', 'EU', '4', 'DL', 'ED', '15', 'ER', 'AP', 'DS', 'BQ', 'AF', 'DS', 'BQ', 'AF', '2', 'EQ', 'DP', 'AP', 'BM', 'AF', 'BM', 'AF']",['397']
469,5,432,460,28,0,34,"['EY', '1', 'AA', '7', 'EQ', 'AP', 'BR', 'AF', 'BM', 'AF', '1', 'AD', 'FA', 'EU', '4', 'DL', 'ED', '15', 'ER', 'AP', 'DS', 'BQ', 'AF', 'DS', 'BQ', 'AF', '2', 'EQ', 'DP', 'AP', 'BM', 'AF', 'BM', 'AF']",['57']
470,5,432,463,31,-333,30,"['EY', '1', 'AA', 'AF', '1', '7', 'EQ', 'AP', 'FA', 'EU', '4', 'DL', 'ED', '15', 'ER', 'AP', 'DS', 'BQ', 'AF', 'DS', 'BQ', 'AF', '2', 'EQ', 'DP', 'AP', 'BM', 'AF', 'BM', 'AF']","['418', '85']"
471,5,432,560,128,0,34,"['EY', '1', 'AA', '7', 'EQ', 'AP', 'BR', 'AF', 'BM', 'AF', '1', 'AD', 'FA', 'EU', '4', 'DL', 'ED', '15', 'ER', 'AP', 'DS', 'BQ', 'AF', 'DS', 'BQ', 'AF', '2', 'EQ', 'DP', 'AP', 'BM', 'AF', 'BM', 'AF']",['124']
472,5,432,643,211,0,34,"['EY', '1', 'AA', '7', 'EQ', 'AP', 'BR', 'AF', 'BM', 'AF', '1', 'AD', 'FA', 'EU', '4', 'DL', 'ED', '15', 'ER', 'AP', 'DS', 'BQ', 'AF', 'DS', 'BQ', 'AF', '2', 'EQ', 'DP', 'AP', 'BM', 'AF', 'BM', 'AF']",['123']
473,5,432,805,373,0,34,"['EY', '1', 'AA', '7', 'EQ', 'AP', 'BR', 'AF', 'BM', 'AF', '1', 'AD', 'FA', 'EU', '4', 'DL', 'ED', '15', 'ER', 'AP', 'DS', 'BQ', 'AF', 'DS', 'BQ', 'AF', '2', 'EQ', 'DP', 'AP', 'BM', 'AF', 'BM', 'AF']",['121']
474,5,432,433,1,0,34,"['EY', '1', 'AA', '7', 'EQ', 'AP', 'BR', 'AF', 'BM', 'AF', '1', 'AD', 'FA', 'EU', 'AF', 'DL', 'ED', '15', 'ER', 'AP', 'DS', 'BQ', 'AF', 'DS', 'BQ', 'AF', '2', 'EQ', 'DP', 'AP', 'BM', '4', 'BM', 'AF']",['184']
475,5,432,538,106,0,34,"['EY', '1', 'AA', '7', 'EQ', 'AP', 'BR', 'AF', 'BM', 'AF', '1', 'AD', 'FA', 'EU', '4', 'DL', 'ED', '15', 'ER', 'AP', 'DS', 'BQ', 'AF', 'DS', 'BQ', 'AF', '2', 'EQ', 'DP', 'AP', 'BM', 'AF', 'BM', 'AF']",['277']
476,5,432,436,4,0,32,"['EY', '1', 'AA', '7', 'EQ', 'AP', 'BR', 'AF', 'BM', 'AF', '1', 'AD', 'FA', 'EU', '4', 'DL', 'ED', '15', 'ER', 'AP', 'DS', 'BQ', 'AF', 'DS', 'BQ', 'AF', '2', 'EQ', 'DP', 'AP', 'BM', 'AF']",['412']
477,5,432,451,19,0,34,"['EY', '1', 'AA', '7', 'EQ', 'AP', 'BR', 'AF', 'BM', 'AF', '1', 'AD', 'FA', 'EU', '4', 'DL', 'ED', '15', 'ER', 'AP', 'DS', 'BQ', 'AF', 'DS', 'BQ', 'AF', '2', 'EQ', 'DP', 'AP', 'BM', 'AF', 'BM', 'AF']",['411']
478,5,432,503,71,0,34,"['EY', '1', 'AA', '7', 'EQ', 'AP', 'BR', 'AF', 'BM', 'AF', '1', 'AD', 'FA', 'EU', '4', 'DL', 'ED', '15', 'ER', 'AP', 'DS', 'BQ', 'AF', 'DS', 'BQ', 'AF', '2', 'EQ', 'DP', 'AP', 'BM', 'AF', 'BM', 'AF']",['410']
479,5,432,476,44,0,34,"['EY', '1', 'AA', '7', 'EQ', 'AP', 'BR', 'AF', 'BM', 'AF', '1', 'AD', 'FA', 'EU', '4', 'DL', 'ED', '15', 'ER', 'AP', 'DS', 'BQ', 'AF', 'DS', 'BQ', 'AF', '2', 'EQ', 'DP', 'AP', 'BM', 'AF', 'BM', 'AF']",['407']
480,5,432,569,137,0,34,"['EY', '1', 'AA', '7', 'EQ', 'AP', 'BR', 'AF', 'BM', 'AF', '1', 'AD', 'FA', 'EU', '4', 'DL', 'ED', '15', 'ER', 'AP', 'DS', 'BQ', 'AF', 'DS', 'BQ', 'AF', '2', 'EQ', 'DP', 'AP', 'BM', 'AF', 'BM', 'AF']",['404']
481,7,433,776,343,197,34,"['EY', '1', 'AA', 'AF', '1', 'AD', 'BR', 'AF', 'BM', '7', 'EQ', 'AP', 'FA', 'EU', '4', 'DL', 'ED', '15', 'ER', 'AP', 'DS', 'BQ', 'AF', 'DS', 'BQ', 'AF', '2', 'EQ', 'DP', 'AP', 'BM', 'AF', 'BM', 'AF']","['313', '116']"
482,10,433,440,7,0,34,"['EY', '1', 'AA', '7', 'EQ', 'AP', 'BR', 'AF', 'BM', 'AF', '1', 'AD', 'FA', 'EU', '4', 'DL', 'ED', '15', 'ER', 'AP', 'DS', 'BQ', 'AF', 'DS', 'BQ', 'AF', '2', 'EQ', 'DP', 'AP', 'BM', 'AF', 'BM', 'AF']",['417']
483,10,433,503,70,0,31,"['EY', '1', 'AA', 'BR', 'AF', 'BM', 'AF', '1', 'AD', 'FA', 'EU', '4', 'DL', 'ED', '15', 'ER', 'AP', 'DS', 'BQ', 'AF', 'DS', 'BQ', 'AF', '2', 'EQ', 'DP', 'AP', 'BM', 'AF', 'BM', 'AF']",['415']
484,10,433,450,17,240,34,"['EY', '1', 'AA', '7', 'EQ', 'AP', 'BR', 'AF', 'BM', 'AF', '1', 'AD', 'FA', 'EU', '4', 'DL', 'ED', '15', 'ER', 'AP', 'DS', 'BQ', 'AF', 'DS', 'BQ', 'AF', '2', 'EQ', 'DP', 'AP', 'BM', 'AF', 'DM', 'BF']","['431', '191']"
485,3,434,479,45,-127,36,"['EY', '1', 'AA', '7', 'EQ', 'AP', 'BR', '7', 'EQ', 'AF', 'BM', 'AF', '1', 'AD', 'FA', 'EU', '4', 'DL', 'ED', '15', 'ER', 'AP', 'DS', 'BQ', 'AF', 'DS', 'BQ', 'AF', '2', 'EQ', 'DP', 'AP', 'BM', 'AF', 'BM', 'AF']","['219', '92']"
486,8,435,475,40,0,31,"['EY', '1', 'AA', 'BR', 'AF', 'BM', 'AF', '1', 'AD', 'FA', 'EU', '4', 'DL', 'ED', '15', 'ER', 'AP', 'DS', 'BQ', 'AF', 'DS', 'BQ', 'AF', '2', 'EQ', 'DP', 'AP', 'BM', 'AF', 'BM', 'AF']",['293']
487,11,435,538,103,-102,34,"['EY', '1', 'AA', 'AF', '1', 'AD', 'BR', 'AF', 'BM', '7', 'EQ', 'AP', 'FA', 'EU', '4', 'DL', 'ED', '15', 'ER', 'AP', 'DS', 'BQ', 'AF', 'DS', 'BQ', 'AF', '2', 'EQ', 'DP', 'AP', 'BM', 'AF', 'BM', 'AF']","['421', '319']"
488,10,436,581,145,0,34,"['EY', '1', 'AA', '7', 'EQ', 'AP', 'BR', 'AF', 'BM', 'AF', '1', 'AD', 'FA', 'EU', '4', 'DL', 'ED', '15', 'ER', 'AP', 'DS', 'BQ', 'AF', 'DS', 'BQ', 'AF', '2', 'EQ', 'DP', 'AP', 'BM', 'AF', 'BM', 'AF']",['37']
489,10,436,479,43,0,34,"['EY', '1', 'AA', '7', 'EQ', 'AP', 'BR', 'AF', 'BM', 'AF', '1', 'AD', 'FA', 'EU', '4', 'DL', 'ED', '15', 'ER', 'AP', 'DS', 'BQ', 'AF', 'DS', 'BQ', 'AF', '2', 'EQ', 'DP', 'AP', 'BM', 'AF', 'BM', 'AF']",['188']
490,7,436,574,138,0,34,"['EY', '1', 'AA', 'AF', '1', 'AD', 'BR', 'AF', 'BM', '7', 'EQ', 'AP', 'FA', 'EU', '4', 'DL', 'ED', '15', 'ER', 'AP', 'DS', 'BQ', 'AF', 'DS', 'BQ', 'AF', '2', 'EQ', 'DP', 'AP', 'BM', 'AF', 'BM', 'AF']",['220']
491,10,436,498,62,0,34,"['EY', '1', 'AA', '7', 'EQ', 'AP', 'BR', 'AF', 'BM', 'AF', '1', 'AD', 'FA', 'EU', '4', 'DL', 'ED', '15', 'ER', 'AP', 'DS', 'BQ', 'AF', 'DS', 'BQ', 'AF', '2', 'EQ', 'DP', 'AP', 'BM', 'AF', 'BM', 'AF']",['288']
492,11,436,552,116,0,35,"['EY', '1', 'AA', 'AF', '1', 'AD', 'BR', 'AF', 'BM', '7', 'EQ', 'AP', 'FA', 'EU', '4', 'DL', 'ED', '15', 'ER', 'AP', 'DS', 'BQ', 'DP', 'DS', 'BQ', 'AF', '2', 'EQ', 'EU', 'AF', 'AP', 'BM', 'AF', 'BM', 'AF']",['310']
493,10,436,498,62,0,37,"['EY', '1', 'AA', '7', 'EQ', 'AP', 'BR', 'AF', 'BM', 'AF', '1', 'AD', 'AF', 'BM', 'AF', 'FA', 'EU', '4', 'DL', 'ED', '15', 'ER', 'AP', 'DS', 'BQ', 'AF', 'DS', 'BQ', 'AF', '2', 'EQ', 'DP', 'AP', 'BM', 'AF', 'BM', 'AF']",['437']
494,10,436,450,14,0,35,"['EY', '1', 'AA', '7', 'EQ', 'AP', 'BR', 'AF', 'BM', 'AF', '1', 'AD', 'FA', 'EU', '4', 'DL', 'ED', '15', 'ER', 'AP', 'DS', 'BQ', 'AF', 'DS', 'BQ', 'AF', '2', 'EQ', 'DP', 'AP', 'BM', 'AF', 'BM', 'AF', 'FB']",['436']
495,10,436,450,14,0,34,"['EY', '1', 'AA', '7', 'EQ', 'AP', 'BR', 'AF', 'BM', 'AF', '1', 'AD', 'FA', 'EU', '4', 'DL', 'ED', '15', 'ER', 'AP', 'DS', 'BQ', 'AF', 'DS', 'BQ', 'AF', '2', 'EQ', 'DP', 'AP', 'BM', 'AQ', 'BK', 'AI']",['434']
496,10,436,488,52,0,34,"['EY', '1', 'AA', '7', 'EQ', 'AP', 'BR', 'AF', 'BM', 'AF', '1', 'AD', 'FA', 'EU', '4', 'DL', 'ED', '15', 'ER', 'AP', 'DS', 'BQ', 'AF', 'DS', 'BQ', 'AF', '2', 'EQ', 'DP', 'AP', 'BM', 'AF', 'BM', 'AF']",['433']
497,10,436,514,78,0,34,"['EY', '1', 'AA', '7', 'EQ', 'AP', 'BR', 'AF', 'BM', 'AF', '1', 'AD', 'FA', 'EU', '4', 'DL', 'ED', '15', 'ER', 'AP', 'DS', 'BQ', 'AF', 'DS', 'BQ', 'AF', '2', 'EQ', 'DP', 'AP', 'BM', 'AF', 'BM', 'AF']",['426']
498,3,437,475,38,0,34,"['EY', '1', 'AA', '7', 'EQ', 'AP', 'BR', 'AF', 'BM', 'AF', '1', 'AD', 'FA', 'EU', '4', 'DL', 'ED', '15', 'ER', 'AP', 'DS', 'BQ', 'AF', 'DS', 'BQ', 'AF', '2', 'EQ', 'DP', 'AP', 'BM', 'AF', 'BM', 'AF']",['64']
499,3,437,714,277,0,34,"['EY', '1', 'AA', '7', 'EQ', 'AP', 'BR', 'AF', 'BM', 'AF', '1', 'AD', 'FA', 'EU', '4', 'DL', 'ED', '15', 'ER', 'AP', 'DS', 'BQ', 'AF', 'DS', 'BQ', 'AF', '2', 'EQ', 'DP', 'AP', 'BM', 'AF', 'BM', 'AF']",['93']
500,9,437,1068,631,0,34,"['EY', '1', 'AA', 'AF', '1', 'AD', 'BR', 'AF', 'BM', '7', 'EQ', 'AP', 'FA', 'EU', '4', 'DL', 'ED', '15', 'ER', 'AP', 'DS', 'BQ', 'AF', 'DS', 'BQ', 'AF', '2', 'EQ', 'DP', 'AP', 'BM', 'AF', 'BM', 'AF']",['164']
501,3,437,465,28,0,34,"['EY', '1', 'AA', '7', 'EQ', 'AP', 'BR', 'AF', 'BM', 'AF', '1', 'AD', 'FA', 'EU', '4', 'DL', 'ED', '15', 'ER', 'AP', 'DS', 'BQ', 'AF', 'DS', 'BQ', 'AF', '2', 'EQ', 'DP', 'AP', 'BM', 'AF', 'BM', 'AF']",['193']
502,3,437,600,163,0,34,"['EY', '1', 'AA', '7', 'EQ', 'AP', 'BR', 'AF', 'BM', 'AF', '1', 'AD', 'FA', 'EU', '4', 'DL', 'ED', '15', 'ER', 'AP', 'DS', 'BQ', 'AF', 'DS', 'BQ', 'AF', '2', 'EQ', 'DP', 'AP', 'BM', 'AF', 'BM', 'AF']",['291']
503,9,437,441,4,0,34,"['EY', '1', 'AA', 'AF', '1', 'AD', 'BR', 'AF', 'BM', '7', 'EQ', 'AP', 'FA', 'EU', '4', 'DL', 'ED', '15', 'ER', 'AP', 'DS', 'BQ', 'AF', 'DS', 'BQ', 'AF', '2', 'EQ', 'DP', 'AP', 'BM', 'AF', 'BM', 'AF']",['314']
504,9,437,479,42,0,34,"['EY', '1', 'AA', 'AF', '1', 'AD', 'BR', 'AF', 'BM', '7', 'EQ', 'AP', 'FA', 'EU', '4', 'DL', 'ED', '15', 'ER', 'AP', 'DS', 'BQ', 'AF', 'DS', 'BQ', 'AF', '2', 'EQ', 'DP', 'AP', 'BM', 'AF', 'BM', 'AF']",['442']
505,9,437,524,87,0,34,"['EY', '1', 'AA', 'AF', '1', 'AD', 'BR', 'AF', 'BM', '7', 'EQ', 'AP', 'FA', 'EU', '4', 'DL', 'ED', '15', 'ER', 'AP', 'DS', 'BQ', 'AF', 'DS', 'BQ', 'AF', '2', 'EQ', 'DP', 'AP', 'BM', 'AF', 'BM', 'AF']",['441']
506,15,437,592,155,0,34,"['EY', '1', 'AA', '7', 'EQ', 'AP', 'BR', 'AF', 'BM', 'AF', '1', 'AD', 'FA', 'EU', '4', 'DL', 'ED', '15', 'ER', 'AP', 'DS', 'BQ', 'AF', 'DS', 'BQ', 'AF', '2', 'EQ', 'DP', 'AP', 'BM', 'AF', 'BM', 'AF']",['440']
507,9,437,466,29,0,34,"['EY', '1', 'AA', 'AF', 'EQ', 'AP', 'BR', 'AF', 'BM', '7', '1', 'AD', 'FA', 'EU', '4', 'DL', 'ED', '15', 'ER', 'AP', 'DS', 'BQ', 'AF', 'DS', 'BQ', 'AF', '2', 'EQ', 'DP', 'AP', 'BM', 'AF', 'BM', 'AF']",['439']
508,11,438,512,74,-16,35,"['EY', '1', 'AA', 'AF', '1', 'AD', 'BR', 'AF', 'BM', '41', '7', 'EQ', 'AP', 'FA', 'EU', '4', 'DL', 'ED', '15', 'ER', 'AP', 'DS', 'BQ', 'AF', 'DS', 'BQ', 'AF', '2', 'EQ', 'DP', 'AP', 'BM', 'AF', 'BM', 'AF']","['461', '445']"
509,15,440,441,1,0,34,"['EY', '1', 'AA', '7', 'EQ', 'AP', 'BR', 'AF', 'BM', 'AF', '1', 'AD', 'FA', 'EU', '4', 'DL', 'ED', '15', 'ER', 'AP', 'DS', 'BQ', 'AF', 'DS', 'BQ', 'AF', '2', 'EQ', 'DP', 'AP', 'BM', 'AF', 'BM', 'AF']",['298']
510,15,440,480,40,0,34,"['EY', '1', 'AA', '7', 'EQ', 'AP', 'BR', 'AF', 'BM', 'AF', '1', 'AD', 'FA', 'EU', '4', 'DL', 'ED', '15', 'ER', 'AP', 'DS', 'BQ', 'AF', 'DS', 'BQ', 'AF', '2', 'EQ', 'DP', 'AP', 'BM', 'AF', 'BM', 'AF']",['296']
511,15,440,479,39,0,34,"['EY', '1', 'AA', '7', 'EQ', 'AP', 'BR', 'AF', 'BM', 'AF', '1', 'AD', 'FA', 'EU', '4', 'DL', 'ED', '15', 'ER', 'AP', 'DS', 'BQ', 'AF', 'DS', 'BQ', 'AF', '2', 'EQ', 'DP', 'AP', 'BM', 'AF', 'BM', 'AF']",['448']
512,15,440,659,219,0,34,"['EY', '1', 'AA', '7', 'EQ', 'AP', 'BR', 'AF', 'BM', 'AF', '1', 'AD', 'FA', 'EU', '4', 'DL', 'ED', '15', 'ER', 'AP', 'DS', 'BQ', 'AF', 'DS', 'BQ', 'AF', '2', 'EQ', 'DP', 'AP', 'BM', 'AF', 'BM', 'AF']",['447']
513,8,441,507,66,0,37,"['EY', '1', 'AA', '7', 'EQ', 'AP', 'BR', 'AF', 'BM', 'AF', '1', 'AD', 'AF', 'BM', 'AF', 'FA', 'EU', '4', 'DL', 'ED', '15', 'ER', 'AP', 'DS', 'BQ', 'AF', 'DS', 'BQ', 'AF', '2', 'EQ', 'DP', 'AP', 'BM', 'AF', 'BM', 'AF']",['139']
514,8,441,548,107,0,34,"['EY', '1', 'AA', '7', 'EQ', 'AP', 'BR', 'AF', 'BM', 'AF', '1', 'AD', 'FA', 'EU', '4', 'DL', 'ED', '15', 'ER', 'AP', 'DS', 'BQ', 'AF', 'DS', 'BQ', 'AF', '2', 'EQ', 'DP', 'AP', 'BM', 'AQ', 'BK', 'AI']",['309']
515,8,441,542,101,0,34,"['EY', '1', 'AA', '7', 'EQ', 'AP', 'BR', 'AF', 'BM', 'AF', '1', 'AD', 'FA', 'EU', '4', 'DL', 'ED', '15', 'ER', 'AP', 'DS', 'BQ', 'AF', 'DS', 'BQ', 'AF', '2', 'EQ', 'DP', 'AP', 'BM', 'AF', 'BM', 'AF']",['307']
516,8,441,522,81,0,30,"['EY', '1', 'AA', '7', 'EQ', 'AP', 'BR', 'AF', 'BM', 'AF', '1', 'AD', 'FA', 'EU', 'ER', 'AP', 'DS', 'BQ', 'AF', 'DS', 'BQ', 'AF', '2', 'EQ', 'DP', 'AP', 'BM', 'AF', 'BM', 'AF']",['306']
517,8,441,536,95,0,34,"['EY', '1', 'AA', '7', 'EQ', 'AP', 'BR', 'AF', 'BM', 'AF', '1', 'AD', 'FA', 'EU', '4', 'DL', 'ED', '15', 'ER', 'AP', 'DS', 'BQ', 'AF', 'DS', 'BQ', 'AF', '2', 'EQ', 'DP', 'AP', 'BM', 'AF', 'BM', 'AF']",['301']
518,8,441,614,173,0,34,"['EY', '1', 'AA', '7', 'EQ', 'AP', 'BR', 'AF', 'BM', 'AF', '1', 'AD', 'FA', 'EU', '4', 'DL', 'ED', '15', 'ER', 'AP', 'DS', 'BQ', 'AF', 'DS', 'BQ', 'AF', '2', 'EQ', 'DP', 'AP', 'BM', 'AF', 'BM', 'AF']",['456']
519,8,441,493,52,0,34,"['EY', '1', 'AA', '7', 'EQ', 'AP', 'EP', 'EI', 'BM', 'AF', '1', 'AD', 'FA', 'EU', '4', 'DL', 'ED', '15', 'ER', 'AP', 'DS', 'BQ', 'AF', 'DS', 'BQ', 'AF', '2', 'EQ', 'DP', 'AP', 'BM', 'AF', 'BM', 'AF']",['455']
520,8,441,556,115,0,34,"['EY', '1', 'AA', '7', 'EQ', 'AP', 'BR', 'AF', 'BM', 'AF', '1', 'AD', 'FA', 'EU', '4', 'DL', 'ED', '15', 'ER', 'AP', 'DS', 'BQ', 'AF', 'DS', 'BQ', 'AF', '2', 'EQ', 'DP', 'AP', 'BM', 'AF', 'BM', 'AF']",['453']
521,8,441,519,78,0,34,"['EY', '1', 'AA', '7', 'EQ', 'AP', 'BR', 'AF', 'BM', 'AF', '1', 'AD', 'FA', 'EU', '4', 'DL', 'ED', '15', 'ER', 'AP', 'DS', 'BQ', 'AF', 'DS', 'BQ', 'AF', '2', 'EQ', 'DP', 'AP', 'BM', 'AF', 'BM', 'AF']",['452']
522,8,441,515,74,0,33,"['EY', '1', 'AA', '7', 'EQ', 'BR', 'AF', 'BM', 'AF', '1', 'AD', 'FA', 'EU', '4', 'DL', 'ED', '15', 'ER', 'AP', 'DS', 'BQ', 'AF', 'DS', 'BQ', 'AF', '2', 'EQ', 'DP', 'AP', 'BM', 'DK', 'BT', 'AF']",['450']
523,8,441,455,14,0,34,"['EY', '1', 'AA', '7', 'EQ', 'AP', 'BR', 'AF', 'BM', 'AF', '1', 'AD', 'FA', 'EU', '4', 'DL', 'ED', '15', 'ER', 'AP', 'DS', 'BQ', 'AF', 'DS', 'BQ', 'AF', '2', 'EQ', 'DP', 'AP', 'BM', 'AF', 'BM', 'AF']",['449']
524,13,442,516,74,0,34,"['EY', '1', 'AA', '7', 'EQ', 'AP', 'BR', 'AF', 'BM', 'AF', '1', 'AD', 'FA', 'EU', '4', 'DL', 'ED', '15', 'ER', 'AP', 'DS', 'BQ', 'AF', 'DS', 'BQ', 'AF', '2', 'EQ', 'DP', 'AP', 'BM', 'AF', 'BM', 'AF']",['460']
525,13,442,459,17,145,34,"['EY', '1', 'AA', '7', 'EQ', 'AP', 'BR', 'AF', 'BM', 'AF', '1', 'AD', 'FA', 'EU', '4', 'DL', 'ED', '15', 'ER', 'AP', 'DS', 'BQ', 'AF', 'DS', 'BQ', 'AF', '2', 'EQ', 'DP', 'AP', 'BM', 'AF', 'BM', 'AF']","['323', '468']"
526,6,443,561,118,0,34,"['EY', '1', 'AA', '7', 'EQ', 'AP', 'BR', 'AF', 'BM', 'AF', '1', 'AD', 'FA', 'EU', '4', 'DL', 'ED', '15', 'ER', 'AP', 'DS', 'BQ', 'AF', 'DS', 'BQ', 'AF', '2', 'EQ', 'DP', 'AP', 'BM', 'AF', 'BM', 'AF']",['318']
527,8,444,569,125,343,12,"['EY', '1', 'AA', 'AF', '1', 'AD', 'BR', 'AF', 'BM', '7', 'EQ', 'AP']","['352', '9']"
528,13,445,454,9,0,34,"['EY', '1', 'AA', '7', 'EQ', 'AP', 'BR', 'AF', 'BM', 'AF', '1', 'AD', 'FA', 'EU', '4', 'DL', 'ED', '15', 'ER', 'AP', 'DS', 'BQ', 'AF', 'DS', 'BQ', 'AF', '2', 'EQ', 'DP', 'AP', 'BM', 'AF', 'BM', 'AF']",['321']
529,6,445,451,6,0,36,"['EY', '1', 'AA', '7', 'EQ', 'AP', 'BR', 'AF', 'BM', 'AF', '1', 'AD', 'FA', 'EU', '4', 'DL', 'ED', 'BM', 'AF', '15', 'ER', 'AP', 'DS', 'BQ', 'AF', 'DS', 'BQ', 'AF', '2', 'EQ', 'DP', 'AP', 'BM', 'AF', 'BM', 'AF']",['462']
530,13,445,488,43,0,37,"['EY', '1', 'AA', '7', 'EQ', 'AP', 'BR', 'AF', 'BM', 'AF', '1', 'AD', 'AF', 'BM', 'AF', 'FA', 'EU', '4', 'DL', 'ED', '15', 'ER', 'AP', 'DS', 'BQ', 'AF', 'DS', 'BQ', 'AF', '2', 'EQ', 'DP', 'AP', 'BM', 'AF', 'BM', 'AF']",['467']
531,13,445,459,14,0,32,"['EY', '1', 'AA', '7', 'EQ', 'AP', 'BR', 'AF', 'BM', 'AF', '1', 'AD', 'FA', 'EU', '6', 'EV', 'ED', '15', 'ER', 'AP', 'DS', 'BQ', 'AF', 'DS', 'BQ', 'AF', '2', 'AP', 'BM', 'AF', 'BM', 'AF']",['466']
532,13,445,459,14,0,30,"['EY', 'AP', 'BR', 'AF', 'BM', 'AF', '1', 'AD', 'FA', 'EU', '4', 'DL', 'ED', '15', 'ER', 'AP', 'DS', 'BQ', 'AF', 'DS', 'BQ', 'AF', '2', 'EQ', 'DP', 'AP', 'BM', 'AF', 'BM', 'AF']",['465']
533,13,445,470,25,0,34,"['EY', '1', 'AA', '7', 'EQ', 'AP', 'BR', 'AF', 'BM', 'AF', '1', 'AD', 'FA', 'EU', '4', 'DL', 'ED', '15', 'ER', 'AP', 'DS', 'BQ', 'AF', 'DS', 'BQ', 'AF', '2', 'EQ', 'DP', 'AP', 'BM', 'AF', 'BM', 'AF']",['464']
534,13,445,485,40,0,34,"['EY', '1', 'AA', '7', 'EQ', 'AP', 'BR', 'AF', 'BM', 'AF', '1', 'AD', 'FA', 'EU', '4', 'DL', 'ED', '15', 'ER', 'AP', 'DS', 'BQ', 'AF', 'DS', 'BQ', 'AF', '2', 'EQ', 'DP', 'AP', 'BM', 'AF', 'BM', 'AF']",['463']
535,6,446,687,241,0,34,"['EY', '1', 'AA', '7', 'EQ', 'AP', 'BR', 'AF', 'BM', 'AF', '1', 'AD', 'FA', 'EU', '4', 'DL', 'ED', '15', 'ER', 'AP', 'DS', 'BQ', 'AF', 'DS', 'BQ', 'AF', '2', 'EQ', 'DP', 'AP', 'BM', 'AF', 'BM', 'AF']",['100']
536,6,446,488,42,0,34,"['EY', '1', 'AA', '7', 'EQ', 'AP', 'BR', 'AF', 'BM', 'AF', '1', 'AD', 'FA', 'EU', '4', 'DL', 'ED', '15', 'ER', 'AP', 'DS', 'BQ', 'AF', 'DS', 'BQ', 'AF', '2', 'EQ', 'DP', 'AP', 'BM', 'AF', 'BM', 'AF']",['148']
537,6,446,536,90,0,36,"['EY', '1', 'AA', '7', 'EQ', 'BR', 'AF', 'AP', 'BR', 'AF', 'BM', 'AF', '1', 'AD', 'FA', 'EU', '4', 'DL', 'ED', '15', 'ER', 'AP', 'DS', 'BQ', 'AF', 'DS', 'BQ', 'AF', '2', 'EQ', 'DP', 'AP', 'BM', 'AF', 'BM', 'AF']",['214']
538,6,446,555,109,0,34,"['EY', '1', 'AA', '7', 'EQ', 'AP', 'BR', 'AF', 'BM', 'AF', '1', 'AD', 'FA', 'EU', '4', 'DL', 'ED', '15', 'ER', 'AP', 'DS', 'BQ', 'AF', 'DS', 'BQ', 'AF', '2', 'EQ', 'DP', 'AP', 'BM', 'AF', 'BM', 'AF']",['213']
539,6,446,752,306,0,34,"['EY', '1', 'AA', '7', 'EQ', 'AP', 'BR', 'AF', 'BM', 'AF', '1', 'AD', 'FA', 'EU', '4', 'DL', 'ED', '15', 'ER', 'AP', 'DS', 'BQ', 'AF', 'DS', 'BQ', 'AF', '2', 'EQ', 'DP', 'AP', 'BM', 'AF', 'BM', 'AF']",['334']
540,6,446,484,38,0,34,"['EY', '1', 'AA', '7', 'EQ', 'AP', 'BR', 'AF', 'BM', 'AF', '1', 'AD', 'FA', 'EU', '4', 'DL', 'ED', '15', 'ER', 'AP', 'DS', 'BQ', 'AF', 'DS', 'BQ', 'AF', '2', 'EQ', 'DP', 'AP', 'BM', 'AF', 'BM', 'AF']",['331']
541,6,446,559,113,0,34,"['EY', '1', 'AA', '7', 'EQ', 'AP', 'BR', 'AF', 'BM', 'AF', '1', 'AD', 'FA', 'EU', '4', 'DL', 'ED', '15', 'ER', 'AP', 'DS', 'BQ', 'AF', 'DS', 'BQ', 'AF', '2', 'EQ', 'DP', 'AP', 'BM', 'AF', 'BM', 'AF']",['330']
542,6,446,760,314,0,34,"['EY', '1', 'AA', '7', 'EQ', 'AP', 'BR', 'AF', 'BM', 'AF', '1', 'AD', 'FA', 'EU', '4', 'DL', 'ED', '15', 'ER', 'AP', 'DS', 'BQ', 'AF', 'DS', 'BQ', 'AF', '2', 'EQ', 'DP', 'AP', 'BM', 'AF', 'BM', 'AF']",['325']
543,6,446,513,67,0,34,"['EY', '1', 'AA', '7', 'EQ', 'AP', 'BR', 'AF', 'BM', 'AF', '1', 'AD', 'FA', 'EU', '4', 'DL', 'ED', '15', 'ER', 'AP', 'DS', 'BQ', 'AF', 'DS', 'BQ', 'AF', '2', 'EQ', 'DP', 'AP', 'BM', 'AF', 'BM', 'AF']",['479']
544,6,446,473,27,0,32,"['EY', '1', 'AA', '7', 'EQ', 'AP', 'BR', 'AF', 'BM', 'AF', '1', 'AD', 'FA', 'EU', '4', 'DL', 'ER', 'AP', 'DS', 'BQ', 'AF', 'DS', 'BQ', 'AF', '2', 'EQ', 'DP', 'AP', 'BM', 'AF', 'BM', 'AF']",['478']
545,6,446,509,63,0,32,"['EY', '1', 'EQ', 'AP', 'BR', 'AF', 'BM', 'AF', '1', 'AD', 'FA', 'EU', '4', 'DL', 'ED', '15', 'ER', 'AP', 'DS', 'BQ', 'AF', 'DS', 'BQ', 'AF', '2', 'EQ', 'DP', 'AP', 'BM', 'AF', 'BM', 'AF']",['477']
546,6,446,536,90,0,34,"['EY', '1', 'AA', '7', 'EQ', 'AP', 'BR', 'AF', 'BM', 'AF', '1', 'AD', 'FA', 'EU', '4', 'DL', 'ED', '15', 'ER', 'AP', 'DS', 'BQ', 'AF', 'DS', 'BQ', 'AF', '2', 'EQ', 'DP', 'AP', 'BM', 'AF', 'BM', 'AF']",['475']
547,6,446,493,47,0,34,"['EY', '1', 'AA', '7', 'EQ', 'AP', 'BR', 'AF', 'BM', 'AF', '1', 'AD', 'FA', 'EU', '4', 'DL', 'ED', '15', 'ER', 'AP', 'DS', 'BQ', 'AF', 'DS', 'BQ', 'AF', '2', 'EQ', 'DP', 'AP', 'BM', 'AF', 'BM', 'AF']",['473']
548,6,446,593,147,0,34,"['EY', '1', 'AA', '7', 'EQ', 'AP', 'BR', 'AF', 'BM', 'AF', '1', 'AD', 'FA', 'EU', '4', 'DL', 'ED', '15', 'ER', 'AP', 'DS', 'BQ', 'AF', 'DS', 'BQ', 'AF', '2', 'EQ', 'DP', 'AP', 'BM', 'AF', 'BM', 'AF']",['472']
549,6,446,506,60,0,34,"['EY', '1', 'AA', '7', 'EQ', 'AP', 'BR', 'AF', 'BM', 'AF', '1', 'AD', 'FA', 'EU', '4', 'DL', 'ED', '15', 'ER', 'AP', 'DS', 'BQ', 'AF', 'DS', 'BQ', 'AF', '2', 'EQ', 'DP', 'AP', 'BM', 'AF', 'BM', 'AF']",['471']
550,8,447,1211,764,-78,12,"['EY', '1', 'AA', 'AF', '1', 'AD', 'BR', 'AF', 'BM', '7', 'EQ', 'AP']","['264', '186']"
551,8,447,474,27,80,34,"['EY', '1', 'AA', 'AF', '1', 'AD', 'BR', 'AF', 'BM', '7', 'EQ', 'AP', 'FA', 'EU', '4', 'DL', 'ED', '15', 'ER', 'AP', 'DS', 'BQ', 'AF', 'DS', 'BQ', 'AF', '2', 'EQ', 'DP', 'AP', 'BM', 'AF', 'BM', 'AF']","['185', '265']"
552,11,447,450,3,0,34,"['EY', '1', 'AA', '7', 'EQ', 'AP', 'BR', 'AF', 'BM', 'AF', '1', 'AD', 'FA', 'EU', '4', 'DL', 'ED', '15', 'ER', 'AP', 'DS', 'BQ', 'AF', 'DS', 'BQ', 'AF', '2', 'EQ', 'DP', 'AP', 'BM', 'AF', 'BM', 'AF']",['336']
553,11,447,556,109,0,34,"['EY', '1', 'AA', '7', 'EQ', 'AP', 'BR', 'AF', 'BM', 'AF', '1', 'AD', 'FA', 'EU', '4', 'DL', 'ED', '15', 'ER', 'AP', 'DS', 'BQ', 'AF', 'DS', 'BQ', 'AF', '2', 'EQ', 'DP', 'AP', 'BM', 'AF', 'DM', 'BF']",['484']
554,8,447,505,58,121,34,"['EY', '1', 'AA', 'AF', '1', 'AD', 'BR', 'AF', 'BM', '7', 'EQ', 'AP', 'FA', 'EU', '4', 'DL', 'ED', '15', 'ER', 'AP', 'DS', 'BQ', 'AF', 'DS', 'BQ', 'AF', '2', 'EQ', 'DP', 'AP', 'BM', 'AF', 'BM', 'AF']","['369', '490']"
555,7,448,460,12,-84,31,"['EY', '1', 'AA', 'BR', 'AF', 'BM', 'AF', '1', 'AD', 'FA', 'EU', '4', 'DL', 'ED', '15', 'ER', 'AP', 'DS', 'BQ', '1', 'AD', 'BQ', 'AF', '2', 'EQ', 'DP', 'AP', 'BM', 'AF', 'BM', 'AF']","['258', '174']"
556,11,448,460,12,0,32,"['EY', '1', 'AA', '7', 'EQ', 'AP', 'BR', 'AF', 'BM', 'AF', '1', 'AD', 'FA', 'EU', '6', 'EV', 'ED', '15', 'ER', 'AP', 'DS', 'BQ', 'AF', 'DS', 'BQ', 'AF', '2', 'AP', 'BM', 'AF', 'BM', 'AF']",['342']
557,4,448,474,26,192,34,"['EY', '1', 'AA', '7', 'EQ', 'AP', 'BR', 'AF', 'BM', 'AF', '1', 'AD', 'FA', 'EU', '4', 'DL', 'ED', '15', 'ER', 'AP', 'DS', 'BQ', 'AF', 'DS', 'BQ', 'AF', '2', 'EQ', 'DP', 'AP', 'BM', 'AF', 'BM', 'AF']","['343', '151']"
558,10,448,743,295,0,34,"['EY', '1', 'AA', 'AF', '1', 'AD', 'BR', 'AF', 'BM', '7', 'EQ', 'AP', 'FA', 'EU', '4', 'DL', 'ED', '15', 'ER', 'AP', 'DS', 'BQ', 'AF', 'DS', 'BQ', 'AF', '2', 'EQ', 'DP', 'AP', 'BM', 'AF', 'BM', 'AF']",['354']
559,10,448,471,23,215,48,"['EY', 'EU', '4', 'DL', 'ED', '15', 'ER', 'AP', 'DS', 'BQ', 'AF', 'DS', 'BQ', 'AF', '2', 'EQ', 'DP', 'AP', 'BM', 'AF', 'BM', 'AF', 'FA', 'EU', '4', 'DL', 'ED', '15', 'ER', 'AP', 'DS', 'BQ', 'AF', 'DS', 'BQ', 'AF', '2', 'EQ', 'DP', 'AP', 'BM', 'AF', 'BM', 'AF', 'FB', '54', '-39', 'AD']","['373', '158']"
560,10,448,507,59,102,34,"['EY', '1', 'AA', 'AF', '1', 'AD', 'BR', 'AF', 'BM', '7', 'EQ', 'AP', 'FA', 'EU', '4', 'DL', 'ED', '15', 'ER', 'AP', 'DS', 'BQ', 'AF', 'DS', 'BQ', 'AF', '2', 'EQ', 'DP', 'AP', 'BM', 'AF', 'BM', 'AF']","['372', '270']"
561,9,448,526,78,468,30,"['EY', '1', 'AA', '7', 'EQ', 'AP', 'BR', 'AF', 'BM', 'AF', '1', 'AD', 'FA', 'EU', 'ER', 'AP', 'DS', 'BQ', 'AF', 'DS', 'BQ', 'AF', '2', 'EQ', 'DP', 'AP', 'BM', 'AF', 'BM', 'AF']","['48', '516']"
562,4,449,487,38,0,32,"['EY', '1', 'AA', '7', 'EQ', 'AP', 'BR', 'AF', 'BM', 'AF', '1', 'AD', 'FA', 'EU', '4', 'DL', 'ED', '15', 'ER', 'AP', 'DS', 'BQ', 'AF', 'DS', 'BQ', 'AF', '2', 'EQ', 'DP', 'AP', 'BM', 'AF']",['348']
563,9,449,570,121,0,31,"['EY', '1', 'AA', 'BR', 'AF', 'BM', 'AF', '1', 'AD', 'FA', 'EU', '4', 'DL', 'ED', '15', 'ER', 'AP', 'DS', 'BQ', 'AF', 'DS', 'BQ', 'AF', '2', 'EQ', 'DP', 'AP', 'BM', 'AF', 'BM', 'AF']",['351']
564,11,450,464,14,0,34,"['EY', '1', 'AA', '7', 'EQ', 'AP', 'BR', 'AF', 'BM', 'AF', '1', 'AD', 'FA', 'EU', '4', 'DL', 'ED', '15', 'ER', 'AP', 'DS', 'BQ', 'AF', 'DS', 'BQ', 'AF', '2', 'EQ', 'DP', 'AP', 'BM', 'AF', 'BM', 'AF']",['150']
565,8,450,474,24,0,34,"['EY', '2', 'AA', 'AF', '3', 'AD', 'BR', 'AF', 'BM', '4', 'EQ', 'AP', 'FA', 'EU', '4', 'DL', 'ED', '15', 'ER', 'AP', 'DS', 'BQ', 'AF', 'DS', 'BQ', 'AF', '2', 'EQ', 'DP', 'AP', 'BM', 'AF', 'BM', 'AF']",['187']
566,11,450,493,43,0,37,"['EY', '1', 'AA', '7', 'EQ', 'AP', 'BR', 'AF', 'BM', 'AF', '1', 'AD', 'AF', 'BM', 'AF', 'FA', 'EU', '4', 'DL', 'ED', '15', 'ER', 'AP', 'DS', 'BQ', 'AF', 'DS', 'BQ', 'AF', '2', 'EQ', 'DP', 'AP', 'BM', 'AF', 'BM', 'AF']",['226']
567,11,450,499,49,0,34,"['EY', '1', 'AA', '7', 'EQ', 'AP', 'BR', 'AF', 'BM', 'AF', '1', 'AD', 'FA', 'EU', '4', 'DL', 'ED', '15', 'ER', 'AP', 'DS', 'BQ', 'AF', 'DS', 'BQ', 'AF', '2', 'EQ', 'DP', 'AP', 'BM', 'AF', 'BM', 'AF']",['224']
568,8,450,583,133,0,35,"['EY', '1', 'AA', 'AF', '1', 'AD', 'BR', 'AP', 'AF', 'BM', '7', 'EQ', 'AP', 'FA', 'EU', '4', 'DL', 'ED', '15', 'ER', 'AP', 'DS', 'BQ', 'AF', 'DS', 'BQ', 'AF', '2', 'EQ', 'DP', 'AP', 'BM', 'AF', 'BM', 'AF']",['266']
569,11,450,464,14,0,35,"['EY', '1', 'AA', '7', 'EQ', 'AP', 'BR', 'AF', 'BM', 'AF', '1', 'AD', 'FA', 'EU', '4', 'DL', 'ED', '15', 'ER', 'AP', 'DS', 'BQ', 'AF', 'DS', 'BQ', 'AF', '2', 'EQ', 'DP', 'AP', 'BM', 'AF', 'BM', 'AF', 'FB']",['340']
570,11,450,513,63,0,34,"['EY', '1', 'AA', '7', 'EQ', 'AP', 'BR', 'AF', 'BM', 'AF', '1', 'AD', 'FA', 'EU', '4', 'DL', 'ED', '15', 'ER', 'AP', 'DS', 'BQ', 'AF', 'DS', 'BQ', 'AF', '2', 'EQ', 'DP', 'AP', 'BM', 'AF', 'BM', 'AF']",['338']
571,11,450,492,42,0,34,"['EY', '1', 'AA', '7', 'EQ', 'AP', 'BR', 'AF', 'BM', 'AF', '1', 'AD', 'FA', 'EU', '4', 'DL', 'BM', 'AF', 'ER', 'AP', 'DS', 'BQ', 'AF', 'DS', 'BQ', 'AF', '2', 'EQ', 'DP', 'AP', 'BM', 'AF', 'ED', '15']",['337']
572,11,450,464,14,0,34,"['EY', '1', 'AA', '7', 'EQ', 'AP', 'BR', 'AF', 'BM', 'AF', '1', 'AD', 'FA', 'EU', '4', 'DL', 'ED', '15', 'ER', 'AP', 'DS', 'BQ', 'AF', 'DS', 'BQ', 'AF', '2', 'EQ', 'DP', 'AP', 'BM', 'AF', 'BM', 'AF']",['497']
573,11,450,658,208,-12,34,"['EY', '1', 'AA', '7', 'EQ', 'AP', 'BR', 'AF', 'BM', 'AF', '1', 'AD', 'FA', 'EU', '4', 'DL', 'ED', '15', 'ER', 'AP', 'DS', 'BQ', 'AF', 'DS', 'BQ', 'AF', '2', 'EQ', 'DP', 'AP', 'BM', 'AF', 'BM', 'AF']","['496', '508']"
574,11,450,455,5,0,37,"['EY', '1', 'AA', '7', 'EQ', 'AP', 'BR', 'AF', 'BM', 'AF', '1', 'AD', 'AF', 'BM', 'AF', 'FA', 'EU', '4', 'DL', 'ED', '15', 'ER', 'AP', 'DS', 'BQ', 'AF', 'DS', 'BQ', 'AF', '2', 'EQ', 'DP', 'AP', 'BM', 'AF', 'BM', 'AF']",['493']
575,11,450,456,6,0,34,"['EY', '1', 'AA', '7', 'EQ', 'AP', 'BR', 'AF', 'BM', 'AF', '1', 'AD', 'FA', 'EU', '4', 'DL', 'ED', '15', 'ER', 'AP', 'DS', 'BQ', 'AF', 'DS', 'BQ', 'AF', '2', 'EQ', 'DP', 'AP', 'BM', 'AF', 'BM', 'AF']",['491']
576,11,450,512,62,0,34,"['EY', '1', 'AA', '7', 'EQ', 'AP', 'BR', 'AF', 'BM', 'AF', '1', 'AD', 'FA', 'EU', '4', 'DL', 'ED', '15', 'ER', 'AP', 'DS', 'BQ', 'AF', 'DS', 'BQ', 'AF', '2', 'EQ', 'DP', 'AP', 'BM', 'AF', 'BM', 'AF']",['489']
577,11,450,556,106,0,34,"['EY', '1', 'AA', '7', 'EQ', 'AP', 'BR', 'AF', 'BM', 'AF', '1', 'AD', 'FA', 'EU', '4', 'DL', 'ED', '15', 'ER', 'AP', 'DS', 'BQ', 'AF', 'DS', 'BQ', 'AF', '2', 'EQ', 'DP', 'AP', 'BM', 'AF', 'BM', 'AF']",['488']
578,4,451,594,143,0,34,"['EY', '1', 'AA', '7', 'EQ', 'AP', 'BR', 'AF', 'BM', 'AF', '1', 'AD', 'FA', 'EU', '4', 'DL', 'ED', '15', 'ER', 'AP', 'DS', 'BQ', 'AF', 'DS', 'BQ', 'AF', '2', 'EQ', 'DP', 'AP', 'BM', 'AF', 'BM', 'AF']",['71']
579,4,451,571,120,0,34,"['EY', '1', 'AA', '7', 'EQ', 'AP', 'BR', 'AF', 'BM', 'AF', '1', 'AD', 'FA', 'EU', '4', 'DL', 'ED', '15', 'ER', 'AP', 'DS', 'BQ', 'AF', 'DS', 'BQ', 'AF', '2', 'EQ', 'DP', 'AP', 'BM', 'AF', 'BM', 'AF']",['236']
580,4,451,474,23,0,34,"['EY', '1', 'AA', '7', 'EQ', 'AP', 'BR', 'AF', 'BM', 'AF', '1', 'AD', 'FA', 'EU', '4', 'DL', 'ED', '15', 'ER', 'AP', 'DS', 'BQ', 'AF', 'DS', 'BQ', 'AF', '2', 'EQ', 'DP', 'AP', 'BM', 'AF', 'BM', 'AF']",['235']
581,10,451,521,70,0,35,"['EY', '1', 'AA', 'AF', '1', 'AD', 'BR', 'AF', 'BM', '41', '7', 'EQ', 'AP', 'FA', 'EU', '4', 'DL', 'ED', '15', 'ER', 'AP', 'DS', 'BQ', 'AF', 'DS', 'BQ', 'AF', '2', 'EQ', 'DP', 'AP', 'BM', 'AF', 'BM', 'AF']",['374']
582,10,451,494,43,0,34,"['EY', '1', 'AA', 'AF', 'EQ', 'AP', 'BR', 'AF', 'BM', '7', '1', 'AD', 'FA', 'EU', '4', 'DL', 'ED', '15', 'ER', 'AP', 'DS', 'BQ', 'AF', 'DS', 'BQ', 'AF', '2', 'EQ', 'DP', 'AP', 'BM', 'AF', 'BM', 'AF']",['507']
583,4,451,471,20,0,34,"['EY', '1', 'AA', '7', 'EQ', 'AP', 'BR', 'AF', 'BM', 'AF', '1', 'AD', 'FA', 'EU', '4', 'DL', 'ED', '15', 'ER', 'AP', 'DS', 'BQ', 'AF', 'DS', 'BQ', 'AF', '2', 'EQ', 'DP', 'AP', 'BM', 'AF', 'BM', 'AF']",['502']
584,10,451,619,168,0,34,"['EY', '1', 'AA', 'AF', '1', 'AD', 'BR', 'AF', 'BM', '7', 'EQ', 'AP', 'FA', 'EU', '4', 'DL', 'ED', '15', 'ER', 'AP', 'DS', 'BQ', 'AF', 'DS', 'BQ', 'AF', '2', 'EQ', 'DP', 'AP', 'BM', 'AF', 'BM', 'AF']",['500']
585,4,451,465,14,0,34,"['EY', '1', 'AA', '7', 'EQ', 'AP', 'BR', 'AF', 'BM', 'AF', '1', 'AD', 'FA', 'EU', '4', 'DL', 'ED', '15', 'ER', 'AP', 'DS', 'BQ', 'AF', 'DS', 'BQ', 'AF', '2', 'EQ', 'DP', 'AP', 'BM', 'AF', 'BM', 'AF']",['499']
586,4,451,554,103,0,34,"['EY', '1', 'AA', '7', 'EQ', 'AP', 'BR', 'AF', 'BM', 'AF', '1', 'AD', 'FA', 'EU', '4', 'DL', 'ED', '15', 'ER', 'AP', 'DS', 'BQ', 'AF', 'DS', 'BQ', 'AF', '2', 'EQ', 'DP', 'AP', 'BM', 'AF', 'BM', 'AF']",['498']
587,9,452,466,14,0,34,"['EY', '1', 'AA', '7', 'EQ', 'AP', 'BR', 'AF', 'BM', 'AF', '1', 'AD', 'FA', 'EU', '4', 'DL', 'ED', '15', 'ER', 'AP', 'DS', 'BQ', 'AF', 'DS', 'BQ', 'AF', '2', 'EQ', 'DP', 'AP', 'BM', 'AF', 'BM', 'AF']",['350']
588,9,452,503,51,154,34,"['EY', '1', 'AA', '7', 'EQ', 'AP', 'BR', 'AF', 'BM', 'AF', '1', 'AD', 'FA', 'EU', '4', 'DL', 'ED', '15', 'ER', 'AP', 'DS', 'BQ', 'AF', 'DS', 'BQ', 'AF', '2', 'EQ', 'DP', 'AP', 'BM', 'AF', 'BM', 'AF']","['361', '515']"
589,7,454,479,25,255,34,"['EY', '1', 'AA', '7', 'EQ', 'AP', 'BR', 'AF', 'BM', 'AF', '1', 'AD', 'FA', 'EU', '4', 'DL', 'ED', '15', 'ER', 'AP', 'DS', 'BQ', 'AF', 'DS', 'BQ', 'AF', '2', 'EQ', 'DP', 'AP', 'BM', 'AF', 'BM', 'AF']","['376', '121']"
590,16,454,529,75,0,34,"['EY', '1', 'AA', '7', 'EQ', 'AP', 'BR', 'AF', 'BM', 'AF', '1', 'AD', 'FA', 'EU', '4', 'DL', 'ED', '15', 'ER', 'AP', 'DS', 'BQ', 'AF', 'DS', 'BQ', 'AF', '2', 'EQ', 'DP', 'AP', 'BM', 'AF', 'BM', 'AF']",['512']
591,9,455,526,71,0,34,"['EY', '1', 'AA', '7', 'EQ', 'AP', 'BR', 'AF', 'BM', 'AF', '1', 'AD', 'FA', 'EU', '4', 'DL', 'ED', '15', 'ER', 'AP', 'DS', 'BQ', 'AF', 'DS', 'BQ', 'AF', '2', 'EQ', 'DP', 'AP', 'BM', 'AF', 'BM', 'AF']",['162']
592,9,455,469,14,0,34,"['EY', '1', 'AA', '7', 'EQ', 'AP', 'BR', 'AF', 'BM', 'AF', '1', 'AD', 'FA', 'EU', '4', 'DL', 'ED', '15', 'ER', 'AP', 'DS', 'BQ', 'AF', 'DS', 'BQ', 'AF', '2', 'EQ', 'DP', 'AP', 'BM', 'AF', 'BM', 'AF']",['244']
593,9,455,703,248,0,35,"['EY', '1', 'AA', '7', 'ES', 'EQ', 'AP', 'BR', 'AF', 'BM', 'AF', '1', 'AD', 'FA', 'EU', '4', 'DL', 'ED', '15', 'ER', 'AP', 'DS', 'BQ', 'AF', 'DS', 'BQ', 'AF', '2', 'EQ', 'DP', 'AP', 'BM', 'AF', 'BM', 'AF']",['368']
594,9,455,621,166,0,34,"['EY', '1', 'AA', '7', 'EQ', 'AP', 'BR', 'AF', 'BM', 'AF', '1', 'AD', 'FA', 'EU', '4', 'DL', 'ED', '15', 'ER', 'AP', 'DS', 'BQ', 'AF', 'DS', 'BQ', 'AF', '2', 'EQ', 'DP', 'AP', 'BM', 'AF', 'BM', 'AF']",['366']
595,9,455,469,14,0,34,"['EY', '1', 'AA', '7', 'EQ', 'AP', 'BR', 'AF', 'BM', 'AF', '1', 'AD', 'FA', 'EU', '4', 'DL', 'ED', '15', 'ER', 'AP', 'DS', 'BQ', 'AF', 'DS', 'BQ', 'AF', '2', 'EQ', 'DP', 'AP', 'BM', 'DK', 'BT', 'AF']",['363']
596,9,455,517,62,0,30,"['EY', '1', 'AA', '7', 'EQ', 'AP', 'BR', 'AF', 'BM', 'AF', '1', 'AD', 'FA', 'EU', 'ER', 'AP', 'DS', 'BQ', 'AF', 'DS', 'BQ', 'AF', '2', 'EQ', 'DP', 'AP', 'BM', 'AF', 'BM', 'AF']",['362']
597,9,455,469,14,0,34,"['EY', '1', 'AA', '7', 'EQ', 'AP', 'BR', 'AF', 'BM', 'AF', '1', 'AD', 'FA', 'EU', '4', 'DL', 'ED', '15', 'ER', 'AP', 'DS', 'BQ', 'AF', 'DS', 'BQ', 'AF', '2', 'EQ', 'DP', 'AP', 'BM', 'AQ', 'BK', 'AI']",['360']
598,9,455,494,39,0,35,"['EY', '1', 'AA', '7', 'EQ', 'AP', 'BR', 'AF', 'BM', 'AF', '1', 'AD', 'FA', 'EU', '4', 'DL', 'ED', '15', 'ER', 'AP', 'DS', 'BQ', 'AF', 'DS', 'BQ', 'AF', '2', 'EQ', 'DP', 'AP', 'BM', 'AF', 'BM', 'AF', 'FB']",['358']
599,9,455,478,23,0,37,"['EY', '1', 'AA', '7', 'EQ', 'AP', 'BR', 'AF', 'BM', 'AF', '1', 'AD', 'AF', 'BM', 'AF', 'FA', 'EU', '4', 'DL', 'ED', '15', 'ER', 'AP', 'DS', 'BQ', 'AF', 'DS', 'BQ', 'AF', '2', 'EQ', 'DP', 'AP', 'BM', 'AF', 'BM', 'AF']",['357']
600,9,455,550,95,0,33,"['EY', '1', 'AA', '7', 'EQ', 'BR', 'AF', 'BM', 'AF', '1', 'AD', 'FA', 'EU', '4', 'DL', 'ED', '15', 'ER', 'AP', 'DS', 'BQ', 'AF', 'DS', 'BQ', 'AF', '2', 'EQ', 'DP', 'AP', 'BM', 'DK', 'BT', 'AF']",['522']
601,9,455,460,5,0,34,"['EY', '1', 'AA', '7', 'EQ', 'AP', 'EP', 'EI', 'BM', 'AF', '1', 'AD', 'FA', 'EU', '4', 'DL', 'ED', '15', 'ER', 'AP', 'DS', 'BQ', 'AF', 'DS', 'BQ', 'AF', '2', 'EQ', 'DP', 'AP', 'BM', 'AF', 'BM', 'AF']",['519']
602,9,455,529,74,0,34,"['EY', '1', 'AA', '7', 'EQ', 'AP', 'BR', 'AF', 'BM', 'AF', '1', 'AD', 'FA', 'EU', '4', 'DL', 'ED', '15', 'ER', 'AP', 'DS', 'BQ', 'AF', 'DS', 'BQ', 'AF', '2', 'EQ', 'DP', 'AP', 'BM', 'AF', 'BM', 'AF']",['518']
603,9,455,490,35,0,34,"['EY', '1', 'AA', '7', 'EQ', 'AP', 'BR', 'AF', 'BQ', 'BM', '-1', 'EM', 'FA', 'EU', '4', 'DL', 'ED', '15', 'ER', 'AP', 'DS', 'BQ', 'AF', 'DS', 'BQ', 'AF', '2', 'EQ', 'DP', 'AP', 'BM', 'AF', 'BM', 'AF']",['517']
604,9,455,633,178,0,37,"['EY', '1', 'AA', '7', 'EQ', 'AP', 'BR', 'AF', 'BM', 'AF', '1', 'AD', 'AF', 'BM', 'AF', 'FA', 'EU', '4', 'DL', 'ED', '15', 'ER', 'AP', 'DS', 'BQ', 'AF', 'DS', 'BQ', 'AF', '2', 'EQ', 'DP', 'AP', 'BM', 'AF', 'BM', 'AF']",['513']
605,14,456,482,26,0,34,"['EY', '1', 'AA', '7', 'EQ', 'AP', 'BR', 'AF', 'BM', 'AF', '1', 'AD', 'FA', 'EU', '4', 'DL', 'ED', '15', 'ER', 'AP', 'DS', 'BQ', 'AF', 'DS', 'BQ', 'AF', '2', 'EQ', 'DP', 'AP', 'BM', 'AF', 'BM', 'AF']",['245']
606,14,456,522,66,0,34,"['EY', '1', 'AA', '7', 'EQ', 'AP', 'BR', 'AF', 'BM', 'AF', '1', 'AD', 'FA', 'EU', '4', 'DL', 'ED', '15', 'ER', 'AP', 'DS', 'BQ', 'AF', 'DS', 'BQ', 'AF', '2', 'EQ', 'DP', 'AP', 'BM', 'AF', 'BM', 'AF']",['525']
607,7,457,471,14,-267,37,"['EY', '1', 'AA', '7', 'EQ', 'AP', 'BR', 'AF', 'BM', 'AF', '1', 'AD', 'FA', 'EU', '4', 'DL', 'ED', 'EQ', 'DP', 'AP', '15', 'ER', 'AP', 'DS', 'BQ', 'AF', 'DS', 'BQ', 'AF', '2', 'EQ', 'DP', 'AP', 'BM', 'AF', 'BM', 'AF']","['259', '526']"
608,7,457,533,76,-4,34,"['EY', '1', 'AA', '7', 'EQ', 'AP', 'BR', 'AF', 'BM', 'AF', '1', 'AD', 'FA', 'EU', '4', 'DL', 'ED', '15', 'ER', 'AP', 'DS', 'BQ', 'AF', 'DS', 'BQ', 'AF', '2', 'EQ', 'DP', 'AP', 'BM', 'AF', 'BM', 'AF']","['536', '540']"
609,9,458,507,49,2,34,"['EY', '1', 'AA', '7', 'EQ', 'AP', 'BR', 'AF', 'BM', 'AF', '1', 'AD', 'FA', 'EU', '4', 'DL', 'ED', '15', 'ER', 'AP', 'DS', 'BQ', 'AF', 'DS', 'BQ', 'AF', '2', 'EQ', 'DP', 'AP', 'BM', 'AF', 'BM', 'AF']","['549', '551']"
610,10,458,568,110,142,30,"['EY', '1', 'AA', 'AF', '1', 'AD', 'BR', 'AF', 'BM', '7', 'EQ', 'AP', 'FA', 'EU', 'ER', 'AP', 'DS', 'BQ', 'AF', 'DS', 'BQ', 'AF', '2', 'EQ', 'DP', 'AP', 'BM', 'AF', 'BM', 'AF']","['561', '419']"
611,14,459,464,5,0,34,"['EY', '1', 'AA', '7', 'EQ', 'AP', 'BR', 'AF', 'BM', 'AF', '1', 'AD', 'FA', 'EU', '4', 'DL', 'ED', '15', 'ER', 'AP', 'DS', 'BQ', 'AF', 'DS', 'BQ', 'AF', '2', 'EQ', 'DP', 'AP', 'BM', 'AF', 'BM', 'AF']",['166']
612,11,459,531,72,249,34,"['EY', '1', 'AA', '7', 'EQ', 'AP', 'BR', 'AF', 'BM', 'AF', '1', 'AD', 'FA', 'EU', '4', 'DL', 'ED', '15', 'ER', 'AP', 'DS', 'BQ', 'AF', 'DS', 'BQ', 'AF', '2', 'EQ', 'DP', 'AP', 'BM', 'AF', 'BM', 'AF']","['424', '175']"
613,14,459,506,47,0,34,"['EY', '1', 'AA', '7', 'EQ', 'AP', 'BR', 'AF', 'BM', 'AF', '1', 'AD', 'FA', 'EU', '4', 'DL', 'ED', '15', 'ER', 'AP', 'DS', 'BQ', 'AF', 'DS', 'BQ', 'AF', '2', 'EQ', 'DP', 'AP', 'BM', 'AF', 'BM', 'AF']",['533']
614,14,459,497,38,0,32,"['EY', '1', 'AA', '7', 'EQ', 'AP', 'BR', 'AF', 'BM', 'AF', '1', 'AD', 'FA', 'EU', '6', 'EV', 'ED', '15', 'ER', 'AP', 'DS', 'BQ', 'AF', 'DS', 'BQ', 'AF', '2', 'AP', 'BM', 'AF', 'BM', 'AF']",['531']
615,14,459,499,40,0,37,"['EY', '1', 'AA', '7', 'EQ', 'AP', 'BR', 'AF', 'BM', 'AF', '1', 'AD', 'AF', 'BM', 'AF', 'FA', 'EU', '4', 'DL', 'ED', '15', 'ER', 'AP', 'DS', 'BQ', 'AF', 'DS', 'BQ', 'AF', '2', 'EQ', 'DP', 'AP', 'BM', 'AF', 'BM', 'AF']",['530']
616,7,460,487,27,0,34,"['EY', '1', 'AA', '7', 'EQ', 'AP', 'BR', 'AF', 'BM', 'AF', '1', 'AD', 'FA', 'EU', '4', 'DL', 'ED', '15', 'ER', 'AP', 'DS', 'BQ', 'AF', 'DS', 'BQ', 'AF', '2', 'EQ', 'DP', 'AP', 'BM', 'AF', 'BM', 'AF']",['172']
617,7,460,479,19,197,34,"['EY', '1', 'AA', 'AF', '1', 'AD', 'BR', 'AF', 'BM', '7', 'EQ', 'AP', 'FA', 'EU', '4', 'DL', 'ED', '15', 'ER', 'AP', 'DS', 'BQ', 'AF', 'DS', 'BQ', 'AF', '2', 'EQ', 'DP', 'AP', 'BM', 'AF', 'BM', 'AF']","['313', '116']"
618,7,460,479,19,92,34,"['EY', '1', 'AA', 'AF', '1', 'AD', 'BR', 'AF', 'BM', '7', 'EQ', 'AP', 'FA', 'EU', '4', 'DL', 'ED', '15', 'ER', 'AP', 'DS', 'BQ', 'AF', 'DS', 'BQ', 'AF', '2', 'EQ', 'DP', 'AP', 'BM', 'AF', 'BM', 'AF']","['312', '220']"
619,7,460,508,48,0,34,"['EY', '1', 'AA', '7', 'EQ', 'AP', 'BR', 'AF', 'BM', 'AF', '1', 'AD', 'FA', 'EU', '4', 'DL', 'ED', '15', 'ER', 'AP', 'DS', 'BQ', 'AF', 'DS', 'BQ', 'AF', '2', 'EQ', 'DP', 'AP', 'BM', 'AF', 'BM', 'AF']",['393']
620,7,460,502,42,0,34,"['EY', '1', 'AA', '7', 'EQ', 'AP', 'BR', 'AF', 'BM', 'AF', '1', 'AD', 'FA', 'EU', '4', 'DL', 'ED', '15', 'ER', 'AP', 'DS', 'BQ', 'AF', 'DS', 'BQ', 'AF', '2', 'EQ', 'DP', 'AP', 'BM', 'AF', 'BM', 'AF']",['392']
621,7,460,608,148,0,34,"['EY', '1', 'AA', '7', 'EQ', 'AP', 'BR', 'AF', 'BM', 'AF', '1', 'AD', 'FA', 'EU', '4', 'DL', 'ED', '15', 'ER', 'AP', 'DS', 'BQ', 'AF', 'DS', 'BQ', 'AF', '2', 'EQ', 'DP', 'AP', 'BM', 'AF', 'BM', 'AF']",['391']
622,7,460,593,133,0,34,"['EY', '1', 'AA', '7', 'EQ', 'AP', 'EP', 'EI', 'BM', 'AF', '1', 'AD', 'FA', 'EU', '4', 'DL', 'ED', '15', 'ER', 'AP', 'DS', 'BQ', 'AF', 'DS', 'BQ', 'AF', '2', 'EQ', 'DP', 'AP', 'BM', 'AF', 'BM', 'AF']",['390']
623,7,460,474,14,0,34,"['EY', '1', 'AA', '7', 'EQ', 'AP', 'BR', 'AF', 'BM', 'AF', '1', 'AD', 'FA', 'EU', '4', 'DL', 'ED', '15', 'ER', 'AP', 'DS', 'BQ', 'AF', 'DS', 'BQ', 'AF', '2', 'EQ', 'DP', 'AP', 'BM', 'AF', 'BM', 'AF']",['383']
624,7,460,521,61,0,34,"['EY', '1', 'AA', '7', 'EQ', 'AP', 'BR', 'AF', 'BM', 'AF', '1', 'AD', 'FA', 'EU', '4', 'DL', 'ED', '15', 'ER', 'AP', 'DS', 'BQ', 'AF', 'DS', 'BQ', 'AF', '2', 'EQ', 'DP', 'AP', 'BM', 'AF', 'BM', 'AF']",['548']
625,7,460,640,180,0,34,"['EY', '1', 'AA', '7', 'EQ', 'AP', 'BR', 'AF', 'BM', 'AF', '1', 'AD', 'FA', 'EU', '4', 'DL', 'ED', '15', 'ER', 'AP', 'DS', 'BQ', 'AF', 'DS', 'BQ', 'AF', '2', 'EQ', 'DP', 'AP', 'BM', 'AF', 'BM', 'AF']",['547']
626,7,460,521,61,0,34,"['EY', '1', 'AA', '7', 'EQ', 'AP', 'BR', 'AF', 'BM', 'AF', '1', 'AD', 'FA', 'EU', '4', 'DL', 'ED', '15', 'ER', 'AP', 'DS', 'BQ', 'AF', 'DS', 'BQ', 'AF', '2', 'EQ', 'DP', 'AP', 'BM', 'AF', 'BM', 'AF']",['546']
627,7,460,508,48,0,30,"['EY', '1', 'AA', '7', 'EQ', 'AP', '1', 'AD', 'FA', 'EU', '4', 'DL', 'ED', '15', 'ER', 'AP', 'DS', 'BQ', 'AF', 'DS', 'BQ', 'AF', '2', 'EQ', 'DP', 'AP', 'BM', 'AF', 'BM', 'AF']",['538']
628,7,460,518,58,0,36,"['EY', '1', 'AA', '7', 'EQ', 'BR', 'AF', 'AP', 'BR', 'AF', 'BM', 'AF', '1', 'AD', 'FA', 'EU', '4', 'DL', 'ED', '15', 'ER', 'AP', 'DS', 'BQ', 'AF', 'DS', 'BQ', 'AF', '2', 'EQ', 'DP', 'AP', 'BM', 'AF', 'BM', 'AF']",['537']
629,7,460,518,58,0,34,"['EY', '1', 'AA', '7', 'EQ', 'AP', 'BR', 'AF', 'BM', 'AF', '1', 'AD', 'FA', 'EU', '4', 'DL', 'ED', '15', 'ER', 'AP', 'DS', 'BQ', 'AF', 'DS', 'BQ', 'AF', '2', 'EQ', 'DP', 'AP', 'BM', 'AF', 'BM', 'AF']",['535']
630,12,461,475,14,0,34,"['EY', '1', 'AA', '7', 'EQ', 'AP', 'BR', 'AF', 'BM', 'AF', '1', 'AD', 'FA', 'EU', '4', 'DL', 'ED', '15', 'ER', 'AP', 'DS', 'BQ', 'AF', 'DS', 'BQ', 'AF', '2', 'EQ', 'DP', 'AP', 'BM', 'AF', 'BM', 'AF']",['395']
631,12,461,475,14,0,34,"['EY', '1', 'AA', '7', 'EQ', 'AP', 'BR', 'AF', 'BM', 'AF', '1', 'AD', 'FA', 'EU', '4', 'DL', 'ED', '15', 'ER', 'AP', 'DS', 'BQ', 'AF', 'DS', 'BQ', 'AF', '2', 'EQ', 'DP', 'AP', 'BM', 'AF', 'DM', 'BF']",['553']
632,5,462,465,3,-86,34,"['EY', '1', 'AA', '7', 'EQ', 'AP', 'BR', 'AF', 'BM', 'AF', '1', 'AD', 'FA', 'EU', '4', 'DL', 'ED', '15', 'ER', 'AP', 'DS', 'BQ', 'AF', 'DS', 'BQ', 'AF', '2', 'EQ', 'DP', 'AP', 'BM', 'AF', 'BM', 'AF']","['267', '181']"
633,5,462,508,46,-5,34,"['EY', '1', 'AA', '7', 'EQ', 'AP', 'BR', 'AF', 'BM', 'AF', '1', 'AD', 'FA', 'EU', '4', 'DL', 'ED', '15', 'ER', 'AP', 'DS', 'BQ', 'AF', 'DS', 'BQ', 'AF', '2', 'EQ', 'DP', 'AP', 'BM', 'AF', 'BM', 'AF']","['585', '580']"
634,5,462,601,139,301,34,"['EY', '1', 'AA', '7', 'EQ', 'AP', 'BR', 'AF', 'BM', 'AF', '1', 'AD', 'FA', 'EU', '4', 'DL', 'ED', '15', 'ER', 'AP', 'DS', 'BQ', 'AF', 'DS', 'BQ', 'AF', '2', 'EQ', 'DP', 'AP', 'BM', 'AF', 'BM', 'AF']","['578', '277']"
635,5,463,515,52,0,32,"['EY', '1', 'AA', '7', 'EQ', 'AP', 'BR', 'AF', 'BM', 'AF', '1', 'AD', 'FA', 'EU', '4', 'DL', 'ED', '15', 'ER', 'AP', 'DS', 'BQ', 'AF', 'DS', 'BQ', 'AF', '2', 'EQ', 'DP', 'AP', 'BM', 'AF']",['412']
636,5,463,501,38,0,30,"['EY', '1', 'AA', '7', 'EQ', 'AP', 'BR', 'AF', 'BM', 'AD', 'FA', 'EU', '4', 'DL', 'ED', '15', 'ER', 'AP', 'DS', 'BQ', 'AF', 'DS', 'BQ', 'AF', '2', 'EQ', 'DP', 'AP', 'BM', 'AF']",['562']
637,12,464,575,111,0,34,"['EY', '1', 'AA', '7', 'EQ', 'AP', 'BR', 'AF', 'BM', 'AF', '1', 'AD', 'FA', 'EU', '4', 'DL', 'ED', '15', 'ER', 'AP', 'DS', 'BQ', 'AF', 'DS', 'BQ', 'AF', '2', 'EQ', 'DP', 'AP', 'BM', 'AF', 'BM', 'AF']",['54']
638,9,464,739,275,0,34,"['EY', '1', 'AA', 'AF', '1', 'AD', 'BR', 'AF', 'BM', '7', 'EQ', 'AP', 'FA', 'EU', '4', 'DL', 'ED', '15', 'ER', 'AP', 'DS', 'BQ', 'AF', 'DS', 'BQ', 'AF', '2', 'EQ', 'DP', 'AP', 'BM', 'AF', 'BM', 'AF']",['164']
639,9,464,502,38,0,35,"['EY', '1', 'AA', 'AF', '1', 'AD', 'BR', 'AF', 'BM', '41', '7', 'EQ', 'AP', 'FA', 'EU', '4', 'DL', 'ED', '15', 'ER', 'AP', 'DS', 'BQ', 'AF', 'DS', 'BQ', 'AF', '2', 'EQ', 'DP', 'AP', 'BM', 'AF', 'BM', 'AF']",['317']
640,9,464,479,15,0,34,"['EY', '1', 'AA', 'AF', '1', 'AD', 'BR', 'AF', 'BM', '7', 'EQ', 'AP', 'FA', 'EU', '4', 'DL', 'ED', '15', 'ER', 'AP', 'DS', 'BQ', 'AF', 'DS', 'BQ', 'AF', '2', 'EQ', 'DP', 'AP', 'BM', 'AF', 'BM', 'AF']",['314']
641,12,464,468,4,0,37,"['EY', '1', 'AA', '7', 'EQ', 'AP', 'BR', 'AF', 'BM', 'AF', '1', 'AD', 'AF', 'BM', 'AF', 'FA', 'EU', '4', 'DL', 'ED', '15', 'ER', 'AP', 'DS', 'BQ', 'AF', 'DS', 'BQ', 'AF', '2', 'EQ', 'DP', 'AP', 'BM', 'AF', 'BM', 'AF']",['398']
642,9,464,488,24,0,34,"['EY', '1', 'AA', 'AF', '1', 'AD', 'BR', 'AF', 'BM', '7', 'EQ', 'AP', 'FA', 'EU', '4', 'DL', 'ED', '15', 'ER', 'AP', 'DS', 'BQ', 'AF', 'DS', 'BQ', 'AF', '2', 'EQ', 'DP', 'AP', 'BM', 'AF', 'BM', 'AF']",['442']
643,9,464,488,24,0,34,"['EY', '1', 'AA', 'AF', '1', 'AD', 'BR', 'AF', 'BM', '7', 'EQ', 'AP', 'FA', 'EU', '4', 'DL', 'ED', '15', 'ER', 'AP', 'DS', 'BQ', 'AF', 'DS', 'BQ', 'AF', '2', 'EQ', 'DP', 'AP', 'BM', 'AF', 'BM', 'AF']",['441']
644,12,464,738,274,0,34,"['EY', '1', 'AA', '7', 'EQ', 'AP', 'BR', 'AF', 'BM', 'AF', '1', 'AD', 'FA', 'EU', '4', 'DL', 'ED', '15', 'ER', 'AP', 'DS', 'BQ', 'AF', 'DS', 'BQ', 'AF', '2', 'EQ', 'DP', 'AP', 'BM', 'AF', 'BM', 'AF']",['577']
645,12,464,592,128,0,34,"['EY', '1', 'AA', '7', 'EQ', 'AP', 'BR', 'AF', 'BM', 'AF', '1', 'AD', 'FA', 'EU', '4', 'DL', 'ED', '15', 'ER', 'AP', 'DS', 'BQ', 'AF', 'DS', 'BQ', 'AF', '2', 'EQ', 'DP', 'AP', 'BM', 'AF', 'BM', 'AF']",['573']
646,9,464,593,129,0,35,"['EY', '1', 'AA', 'AF', '1', 'AD', 'BR', 'AP', 'AF', 'BM', '7', 'EQ', 'AP', 'FA', 'EU', '4', 'DL', 'ED', '15', 'ER', 'AP', 'DS', 'BQ', 'AF', 'DS', 'BQ', 'AF', '2', 'EQ', 'DP', 'AP', 'BM', 'AF', 'BM', 'AF']",['568']
647,12,464,468,4,0,34,"['EY', '1', 'AA', '7', 'EQ', 'AP', 'BR', 'AF', 'BM', 'AF', '1', 'AD', 'FA', 'EU', '4', 'DL', 'ED', '15', 'ER', 'AP', 'DS', 'BQ', 'AF', 'DS', 'BQ', 'AF', '2', 'EQ', 'DP', 'AP', 'BM', 'AF', 'BM', 'AF']",['567']
648,12,464,478,14,0,37,"['EY', '1', 'AA', '7', 'EQ', 'AP', 'BR', 'AF', 'BM', 'AF', '1', 'AD', 'AF', 'BM', 'AF', 'FA', 'EU', '4', 'DL', 'ED', '15', 'ER', 'AP', 'DS', 'BQ', 'AF', 'DS', 'BQ', 'AF', '2', 'EQ', 'DP', 'AP', 'BM', 'AF', 'BM', 'AF']",['566']
649,5,465,604,139,0,34,"['EY', '1', 'AA', '7', 'EQ', 'AP', 'BR', 'AF', 'BM', 'AF', '1', 'AD', 'FA', 'EU', '4', 'DL', 'ED', '15', 'ER', 'AP', 'DS', 'BQ', 'AF', 'DS', 'BQ', 'AF', '2', 'EQ', 'DP', 'AP', 'BM', 'AF', 'BM', 'AF']",['57']
650,5,465,567,102,0,34,"['EY', '1', 'AA', '7', 'EQ', 'AP', 'BR', 'AF', 'BM', 'AF', '1', 'AD', 'FA', 'EU', '4', 'DL', 'ED', '15', 'ER', 'AP', 'DS', 'BQ', 'AF', 'DS', 'BQ', 'AF', '2', 'EQ', 'DP', 'AP', 'BM', 'AF', 'BM', 'AF']",['124']
651,5,465,488,23,0,34,"['EY', '1', 'AA', '7', 'EQ', 'AP', 'BR', 'AF', 'BM', 'AF', '1', 'AD', 'FA', 'EU', '4', 'DL', 'ED', '15', 'ER', 'AP', 'DS', 'BQ', 'AF', 'DS', 'BQ', 'AF', '2', 'EQ', 'DP', 'AP', 'BM', 'AF', 'BM', 'AF']",['123']
652,8,465,583,118,0,31,"['EY', '1', 'AA', 'BR', 'AF', 'BM', 'AF', '1', 'AD', 'FA', 'EU', '4', 'DL', 'ED', '15', 'ER', 'AP', 'DS', 'BQ', 'AF', 'DS', 'BQ', 'AF', '2', 'EQ', 'DP', 'AP', 'BM', 'AF', 'BM', 'AF']",['293']
653,5,465,517,52,0,31,"['EY', '1', 'AA', '7', 'EQ', 'AP', 'BR', 'AF', 'BM', 'AF', '1', 'AD', 'FA', 'EU', '4', 'DL', 'ED', '15', 'ER', 'AP', 'DS', 'BQ', 'AF', 'DS', 'BQ', 'DP', 'AP', 'BM', 'AF', 'BM', 'AF']",['411']
654,5,465,474,9,0,34,"['EY', '1', 'AA', '7', 'EQ', 'AP', 'BR', 'AF', 'BM', 'AF', '1', 'AD', 'FA', 'EU', '4', 'DL', 'ED', '15', 'ER', 'AP', 'DS', 'BQ', 'AF', 'DS', 'BQ', 'AF', '2', 'EQ', 'DP', 'AP', 'BM', 'AF', 'BM', 'AF']",['404']
655,5,465,468,3,0,34,"['EY', '1', 'AA', '7', 'EQ', 'AP', 'BR', 'AF', 'BM', 'AF', '1', 'AD', 'FA', 'EU', '4', 'DL', 'ED', '15', 'ER', 'AP', 'DS', 'BQ', 'AF', 'DS', 'BQ', 'AF', '2', 'EQ', 'DP', 'AP', 'BM', 'AF', 'BM', 'AF']",['583']
656,5,465,546,81,0,34,"['EY', '1', 'AA', '7', 'EQ', 'AP', 'BR', 'AF', 'BM', 'AF', '1', 'AD', 'FA', 'EU', '4', 'DL', 'ED', '15', 'ER', 'AP', 'DS', 'BQ', 'AF', 'DS', 'BQ', 'AF', '2', 'EQ', 'DP', 'AP', 'BM', 'AF', 'BM', 'AF']",['579']
657,10,466,547,81,0,34,"['EY', '1', 'AA', '7', 'EQ', 'AP', 'BR', 'AF', 'BM', 'AF', '1', 'AD', 'FA', 'EU', '4', 'DL', 'ED', '15', 'ER', 'AP', 'DS', 'BQ', 'AF', 'DS', 'BQ', 'AF', '2', 'EQ', 'DP', 'AP', 'BM', 'AF', 'BM', 'AF']",['417']
658,10,466,480,14,0,34,"['EY', '1', 'AA', '7', 'EQ', 'AP', 'BR', 'AF', 'BM', 'AF', '1', 'AD', 'FA', 'EU', '4', 'DL', 'ED', '15', 'ER', 'AP', 'DS', 'BQ', 'AF', 'DS', 'BQ', 'AF', '2', 'EQ', 'DP', 'BV', 'AA', 'AF', 'BM', 'AF']",['588']
659,10,466,483,17,170,34,"['EY', '1', 'AA', '7', 'EQ', 'AP', 'BR', 'AF', 'BQ', 'BM', '-1', 'EM', 'FA', 'EU', '4', 'DL', 'ED', '15', 'ER', 'AP', 'DS', 'BQ', 'AF', 'DS', 'BQ', 'AF', '2', 'EQ', 'DP', 'AP', 'BM', 'AF', 'BM', 'AF']","['433', '603']"
660,8,468,474,6,0,34,"['EY', '1', 'AA', '7', 'EQ', 'AP', 'BR', 'AF', 'BM', 'AF', '1', 'AD', 'FA', 'EU', '4', 'DL', 'ED', '15', 'ER', 'AP', 'DS', 'BQ', 'AF', 'DS', 'BQ', 'AF', '2', 'EQ', 'DP', 'AP', 'BM', 'AF', 'BM', 'AF']",['589']
661,10,469,580,111,0,34,"['EY', '1', 'AA', '7', 'EQ', 'AP', 'BR', 'AF', 'BM', 'AF', '1', 'AD', 'FA', 'EU', '4', 'DL', 'ED', '15', 'ER', 'AP', 'DS', 'BQ', 'AF', 'DS', 'BQ', 'AF', '2', 'EQ', 'DP', 'AP', 'BM', 'AF', 'BM', 'AF']",['188']
662,10,469,516,47,0,34,"['EY', '1', 'AA', '7', 'EQ', 'AP', 'BR', 'AF', 'BM', 'AF', '1', 'AD', 'FA', 'EU', '4', 'DL', 'ED', '15', 'ER', 'AP', 'DS', 'BQ', 'AF', 'DS', 'BQ', 'AF', '2', 'EQ', 'DP', 'AP', 'BM', 'AF', 'BM', 'AF']",['288']
663,10,469,497,28,0,34,"['EY', '1', 'AA', '7', 'EQ', 'AP', 'BR', 'AF', 'BM', 'AF', '1', 'AD', 'FA', 'EU', '4', 'DL', 'ED', '15', 'ER', 'AP', 'DS', 'BQ', 'AF', 'DS', 'BQ', 'AF', '2', 'EQ', 'DP', 'AP', 'BM', 'AF', 'BM', 'AF']",['427']
664,10,469,611,142,0,34,"['EY', '1', 'AA', '7', 'EQ', 'AP', 'BR', 'AF', 'BM', 'AF', '1', 'AD', 'FA', 'EU', '4', 'DL', 'ED', '15', 'ER', 'AP', 'DS', 'BQ', 'AF', 'DS', 'BQ', 'AF', '2', 'EQ', 'DP', 'AP', 'BM', 'AF', 'BM', 'AF']",['426']
665,10,469,509,40,0,37,"['EY', '1', 'AA', '7', 'EQ', 'AP', 'BR', 'AF', 'BM', 'AF', '1', 'AD', 'AF', 'BM', 'AF', 'FA', 'EU', '4', 'DL', 'ED', '15', 'ER', 'AP', 'DS', 'BQ', 'AF', 'DS', 'BQ', 'AF', '2', 'EQ', 'DP', 'AP', 'BM', 'AF', 'BM', 'AF']",['604']
666,10,469,502,33,0,34,"['EY', '1', 'AA', '7', 'EQ', 'AP', 'BR', 'AF', 'BM', 'AF', '1', 'AD', 'FA', 'EU', '4', 'DL', 'ED', '15', 'ER', 'AP', 'DS', 'BQ', 'AF', 'DS', 'BQ', 'AF', '2', 'EQ', 'DP', 'AP', 'BM', 'AF', 'BM', 'AF']",['602']
667,10,469,526,57,0,37,"['EY', '1', 'AA', '7', 'EQ', 'AP', 'BR', 'AF', 'BM', 'AF', '1', 'AD', 'AF', 'BM', 'AF', 'FA', 'EU', '4', 'DL', 'ED', '15', 'ER', 'AP', 'DS', 'BQ', 'AF', 'DS', 'BQ', 'AF', '2', 'EQ', 'DP', 'AP', 'BM', 'AF', 'BM', 'AF']",['599']
668,10,469,483,14,0,13,"['EY', '1', 'AA', '7', 'EQ', 'AP', 'BR', 'AF', 'BM', 'AF', '1', 'AD', 'FA']",['598']
669,10,469,483,14,0,34,"['EY', '1', 'AA', '7', 'EQ', 'AP', 'BR', 'AF', 'BM', 'AF', '1', 'AD', 'FA', 'EU', '4', 'DL', 'ED', '15', 'ER', 'AP', 'DS', 'BQ', 'AF', 'DS', 'BQ', 'AF', '2', 'EQ', 'DP', 'AP', 'BM', 'AF', 'BM', 'AF']",['594']
670,10,469,483,14,0,34,"['EY', '1', 'AA', '7', 'EQ', 'AP', 'BR', 'AF', 'BM', 'AF', '1', 'AD', 'FA', 'EU', '4', 'DL', 'ED', '15', 'ER', 'AP', 'DS', 'BQ', 'AF', 'DS', 'BQ', 'AF', '2', 'EQ', 'DP', 'AP', 'BM', 'AF', 'BM', 'AF']",['591']
671,3,470,479,9,0,34,"['EY', '1', 'AA', '7', 'EQ', 'AP', 'BR', 'AF', 'BM', 'AF', '1', 'AD', 'FA', 'EU', '4', 'DL', 'ED', '15', 'ER', 'AP', 'DS', 'BQ', 'AF', 'DS', 'BQ', 'AF', '2', 'EQ', 'DP', 'AP', 'BM', 'AF', 'BM', 'AF']",['64']
672,3,470,516,46,0,33,"['EY', '1', 'AA', '7', 'EQ', 'AP', 'BR', 'BM', 'AF', '1', 'AD', 'FA', 'EU', '4', 'DL', 'ED', '15', 'ER', 'AP', 'DS', 'BQ', 'AF', 'DS', 'BQ', 'AF', '2', 'EQ', 'DP', 'AP', 'BM', 'AF', 'BM', 'AF']",['93']
673,3,470,479,9,0,34,"['EY', '1', 'AA', '7', 'EQ', 'AP', 'BR', 'AF', 'BM', 'AF', '1', 'AD', 'FA', 'EU', '4', 'DL', 'ED', '15', 'ER', 'AP', 'DS', 'BQ', 'AF', 'DS', 'BQ', 'AF', '2', 'EQ', 'DP', 'AP', 'BM', 'AF', 'BM', 'AF']",['193']
674,9,470,552,82,0,34,"['EY', '1', 'AA', 'AF', 'EQ', 'AP', 'BR', 'AF', 'BM', '7', '1', 'AD', 'FA', 'EU', '4', 'DL', 'ED', '15', 'ER', 'AP', 'DS', 'BQ', 'AF', 'DS', 'BQ', 'AF', '2', 'EQ', 'DP', 'AP', 'BM', 'AF', 'BM', 'AF']",['439']
675,15,470,472,2,0,34,"['EY', '1', 'AA', '7', 'EQ', 'AP', 'BR', 'AF', 'BM', 'AF', '1', 'AD', 'FA', 'EU', '4', 'DL', 'ED', '15', 'ER', 'AP', 'DS', 'BQ', 'AF', 'DS', 'BQ', 'AF', '2', 'EQ', 'DP', 'AP', 'BM', 'AF', 'BM', 'AF']",['606']
676,15,470,540,70,0,34,"['EY', '1', 'AA', '7', 'EQ', 'AP', 'BR', 'AF', 'BM', 'AF', '1', 'AD', 'FA', 'EU', '4', 'DL', 'ED', '15', 'ER', 'AP', 'DS', 'BQ', 'AF', 'DS', 'BQ', 'AF', '2', 'EQ', 'DP', 'AP', 'BM', 'AF', 'BM', 'AF']",['605']
677,15,470,527,57,-1,35,"['EY', '1', 'AA', '7', 'EQ', 'AP', 'BR', 'AF', 'BM', 'AF', '1', 'AD', 'AF', 'BM', 'AF', 'FA', 'EU', '6', 'EV', 'ED', '15', 'ER', 'AP', 'DS', 'BQ', 'AF', 'DS', 'BQ', 'AF', '2', 'AP', 'BM', 'AF', 'BM', 'AF']","['614', '615']"
678,8,471,485,14,0,34,"['EY', '1', 'AA', '7', 'EQ', 'AP', 'BR', 'AF', 'BM', 'AF', '1', 'AD', 'FA', 'EU', '4', 'DL', 'ED', '15', 'ER', 'AP', 'DS', 'BQ', 'AF', 'DS', 'BQ', 'AF', '2', 'EQ', 'DP', 'AP', 'BM', 'AF', 'BM', 'AF']",['443']
679,8,471,474,3,0,34,"['EY', '1', 'AA', '7', 'EQ', 'AP', 'BR', 'AF', 'BM', 'AF', '1', 'AD', 'FA', 'EU', '4', 'DL', 'ED', '15', 'ER', 'AP', 'DS', 'BQ', 'AF', 'DS', 'BQ', 'AF', '2', 'EQ', 'DP', 'AP', 'BM', 'AF', 'BM', 'AF']",['608']
680,8,471,541,70,167,34,"['EY', '1', 'AA', '7', 'EQ', 'AP', 'BR', 'AF', 'BM', 'AF', '1', 'AD', 'FA', 'EU', '4', 'DL', 'ED', '15', 'ER', 'AP', 'DS', 'BQ', 'AF', 'DS', 'BQ', 'AF', '2', 'EQ', 'DP', 'AP', 'BM', 'AF', 'BM', 'AF']","['619', '452']"
681,10,472,581,109,0,34,"['EY', '1', 'AA', '7', 'EQ', 'AP', 'BR', 'AF', 'BM', 'AF', '1', 'AD', 'FA', 'EU', '4', 'DL', 'ED', '15', 'ER', 'AP', 'DS', 'BQ', 'AF', 'DS', 'BQ', 'AF', '2', 'EQ', 'DP', 'AP', 'BM', 'AF', 'BM', 'AF']",['609']
682,6,473,512,39,-433,34,"['EY', '1', 'AA', 'AF', '1', 'AD', 'BR', 'AF', 'BM', '7', 'EQ', 'AP', 'FA', 'EU', '4', 'DL', 'ED', '15', 'ER', 'AP', 'DS', 'BQ', 'AF', 'DS', 'BQ', 'AF', '2', 'EQ', 'DP', 'AP', 'BM', 'AF', 'BM', 'AF']","['185', '618']"
683,15,473,478,5,0,34,"['EY', '1', 'AA', '7', 'EQ', 'AP', 'BR', 'AF', 'BM', 'AF', '1', 'AD', 'FA', 'EU', '4', 'DL', 'ED', '15', 'ER', 'AP', 'DS', 'BQ', 'AF', 'DS', 'BQ', 'AF', '2', 'EQ', 'DP', 'AP', 'BM', 'AF', 'BM', 'AF']",['296']
684,15,473,588,115,0,31,"['EY', '1', 'AA', '7', 'EQ', 'AP', 'BR', 'AF', 'BM', 'AF', '1', 'AD', 'FA', 'EU', '4', 'DL', 'ED', '15', 'BQ', 'AF', 'DS', 'BQ', 'AF', '2', 'EQ', 'DP', 'AP', 'BM', 'AF', 'BM', 'AF']",['448']
685,15,473,478,5,0,34,"['EY', '1', 'AA', '7', 'EQ', 'AP', 'BR', 'AF', 'BM', 'AF', '1', 'AD', 'FA', 'EU', '4', 'DL', 'ED', '15', 'ER', 'AP', 'DS', 'BQ', 'AF', 'DS', 'BQ', 'AF', '2', 'EQ', 'DP', 'AP', 'BM', 'AF', 'BM', 'AF']",['613']
686,12,473,551,78,0,34,"['EY', '1', 'AA', '7', 'EQ', 'AP', 'BR', 'AF', 'BM', 'AF', '1', 'AD', 'FA', 'EU', '4', 'DL', 'ED', '15', 'ER', 'AP', 'DS', 'BQ', 'AF', 'DS', 'BQ', 'AF', '2', 'EQ', 'DP', 'AP', 'BM', 'AF', 'BM', 'AF']",['612']
687,8,474,592,118,0,35,"['EY', '1', 'AA', '7', 'EQ', 'AP', 'BR', 'AF', 'BM', 'AF', '1', 'AD', 'FA', 'EU', '4', 'DL', 'ED', '15', 'ER', 'AP', 'DS', 'BQ', 'AF', 'DS', 'BQ', 'AF', '2', 'EQ', 'DP', 'AP', 'BM', 'AF', 'BM', 'AF', 'FB']",['203']
688,8,474,550,76,0,34,"['EY', '1', 'AA', '7', 'EQ', 'AP', 'BR', 'AF', 'BM', 'AF', '1', 'AD', 'FA', 'EU', '4', 'DL', 'ED', '15', 'ER', 'AP', 'DS', 'BQ', 'AF', 'DS', 'BQ', 'AF', '2', 'EQ', 'DP', 'AP', 'BM', 'AF', 'BM', 'AF']",['307']
689,8,474,488,14,0,34,"['EY', '1', 'AA', '7', 'EQ', 'AP', 'BR', 'AF', 'BM', 'AF', '1', 'AD', 'FA', 'EU', '4', 'DL', 'ED', '15', 'ER', 'AP', 'DS', 'BQ', 'AF', 'DS', 'BQ', 'AF', '2', 'EQ', 'DP', 'AP', 'BM', 'AF', 'BM', 'AF']",['306']
690,8,474,502,28,0,34,"['EY', '1', 'AA', '7', 'EQ', 'AP', 'BR', 'AF', 'BM', 'AF', '1', 'AD', 'FA', 'EU', '4', 'DL', 'ED', '15', 'ER', 'AP', 'DS', 'BQ', 'AF', 'DS', 'BQ', 'AF', '2', 'EQ', 'DP', 'AP', 'BM', 'AF', 'BM', 'AF']",['301']
691,8,474,568,94,0,34,"['EY', '1', 'AA', '7', 'EQ', 'AP', 'BR', 'AF', 'BM', 'AF', '1', 'AD', 'FA', 'EU', '4', 'DL', 'ED', '15', 'ER', 'AP', 'DS', 'BQ', 'AF', 'DS', 'BQ', 'AF', '2', 'EQ', 'DP', 'AP', 'BM', 'AF', 'BM', 'AF']",['456']
692,8,474,507,33,0,34,"['EY', '1', 'AA', '7', 'EQ', 'AP', 'EP', 'EI', 'BM', 'AF', '1', 'AD', 'FA', 'EU', '4', 'DL', 'ED', '15', 'ER', 'AP', 'DS', 'BQ', 'AF', 'DS', 'BQ', 'AF', '2', 'EQ', 'DP', 'AP', 'BM', 'AF', 'BM', 'AF']",['455']
693,8,474,512,38,0,34,"['EY', '1', 'AA', '7', 'EQ', 'AP', 'BR', 'AF', 'BM', 'AF', '1', 'AD', 'FA', 'EU', '4', 'DL', 'ED', '15', 'ER', 'AP', 'DS', 'BQ', 'AF', 'DS', 'BQ', 'AF', '2', 'EQ', 'DP', 'AP', 'BM', 'DK', 'BT', 'AF']",['450']
694,8,474,655,181,0,34,"['EY', '1', 'AA', '7', 'EQ', 'AP', 'BR', 'AF', 'BM', 'AF', '1', 'AD', 'FA', 'EU', '4', 'DL', 'ED', '15', 'ER', 'AP', 'DS', 'BQ', 'AF', 'DS', 'BQ', 'AF', '2', 'EQ', 'DP', 'AP', 'BM', 'AF', 'BM', 'AF']",['449']
695,8,474,511,37,0,34,"['EY', '1', 'AA', '7', 'EQ', 'AP', 'BR', 'AF', 'BM', 'AF', '1', 'AD', 'FA', 'EU', '4', 'DL', 'ED', '15', 'ER', 'AP', 'DS', 'BQ', 'AF', 'DS', 'BQ', 'AF', '2', 'EQ', 'DP', 'AP', 'BM', 'AF', 'BM', 'AF']",['629']
696,8,474,488,14,0,36,"['EY', '1', 'AA', '7', 'EQ', 'BR', 'AF', 'AP', 'BR', 'AF', 'BM', 'AF', '1', 'AD', 'FA', 'EU', '4', 'DL', 'ED', '15', 'ER', 'AP', 'DS', 'BQ', 'AF', 'DS', 'BQ', 'AF', '2', 'EQ', 'DP', 'AP', 'BM', 'AF', 'BM', 'AF']",['628']
697,8,474,560,86,0,30,"['EY', '1', 'AA', '7', 'EQ', 'AP', '1', 'AD', 'FA', 'EU', '4', 'DL', 'ED', '15', 'ER', 'AP', 'DS', 'BQ', 'AF', 'DS', 'BQ', 'AF', '2', 'EQ', 'DP', 'AP', 'BM', 'AF', 'BM', 'AF']",['627']
698,8,474,485,11,0,34,"['EY', '1', 'AA', '7', 'EQ', 'AP', 'BR', 'AF', 'BM', 'AF', '1', 'AD', 'FA', 'EU', '4', 'DL', 'ED', '15', 'ER', 'AP', 'DS', 'BQ', 'AF', 'DS', 'BQ', 'AF', '2', 'EQ', 'DP', 'AP', 'BM', 'AF', 'BM', 'AF']",['626']
699,8,474,522,48,0,34,"['EY', '1', 'AA', '7', 'EQ', 'AP', 'BR', 'AF', 'BM', 'AF', '1', 'AD', 'FA', 'EU', '4', 'DL', 'ED', '15', 'ER', 'AP', 'DS', 'BQ', 'AF', 'DS', 'BQ', 'AF', '2', 'EQ', 'DP', 'AP', 'BM', 'AF', 'BM', 'AF']",['624']
700,8,474,554,80,0,36,"['EY', '1', '96', 'BK', 'AA', '7', 'EQ', 'AP', 'EP', 'EI', 'BM', 'AF', '1', 'AD', 'FA', 'EU', '4', 'DL', 'ED', '15', 'ER', 'AP', 'DS', 'BQ', 'AF', 'DS', 'BQ', 'AF', '2', 'EQ', 'DP', 'AP', 'BM', 'AF', 'BM', 'AF']",['622']
701,8,474,525,51,0,33,"['EY', '1', 'AA', '7', 'EQ', 'AP', 'BR', 'AF', 'BM', 'AF', '1', 'AD', 'FA', 'EU', '4', 'DL', 'ED', '15', 'ER', 'AP', 'DS', 'BQ', 'AF', 'DS', 'BQ', '2', 'EQ', 'DP', 'AP', 'BM', 'AF', 'BM', 'AF']",['621']
702,8,474,531,57,0,34,"['EY', '1', 'AA', '7', 'EQ', 'AP', 'BR', 'AF', 'BM', 'AF', '1', 'AD', 'FA', 'EU', '4', 'DL', 'ED', '15', 'ER', 'AP', 'DS', 'BQ', 'AF', 'DS', 'BQ', 'AF', '2', 'EQ', 'DP', 'AP', 'BM', 'AF', 'BM', 'AF']",['620']
703,8,474,602,128,0,36,"['EY', '1', 'AA', '7', 'EQ', 'AP', 'BR', 'AF', 'BM', 'AF', '1', 'AD', 'FA', 'EU', '4', 'DL', 'AF', '2', 'ED', '15', 'ER', 'AP', 'DS', 'BQ', 'AF', 'DS', 'BQ', 'AF', '2', 'EQ', 'DP', 'AP', 'BM', 'AF', 'BM', 'AF']",['616']
704,10,475,663,188,19,34,"['EY', '1', 'AA', '7', 'EQ', 'AP', 'BR', 'AF', 'BM', 'AF', '1', 'AD', 'FA', 'EU', '4', 'DL', 'ED', '15', 'ER', 'AP', 'DS', 'BQ', 'AF', 'DS', 'BQ', 'AF', '2', 'EQ', 'DP', 'AP', 'BM', 'AF', 'BM', 'AF']","['251', '270']"
705,6,476,556,80,-159,34,"['EY', '1', 'AA', '7', 'EQ', 'AP', 'BR', 'AF', 'BM', 'AF', '1', 'AD', 'FA', 'EU', '4', 'DL', 'ED', '15', 'ER', 'AP', 'DS', 'BQ', 'AF', 'DS', 'BQ', 'AF', '2', 'EQ', 'DP', 'AP', 'BM', 'AF', 'BM', 'AF']","['634', '475']"
706,6,476,607,131,229,31,"['EY', '1', 'AA', 'BR', 'AF', 'BM', 'AF', '1', 'AD', 'FA', 'EU', '4', 'DL', 'ED', '15', 'ER', 'AP', 'DS', 'BQ', 'AF', 'DS', 'BQ', 'AF', '2', 'EQ', 'DP', 'AP', 'BM', 'AF', 'BM', 'AF']","['472', '243']"
707,6,476,607,131,0,37,"['EY', '1', 'AA', '7', 'EQ', 'AP', 'BR', 'AF', 'BM', 'AF', '1', 'AD', 'FA', 'DA', 'BD', 'BJ', 'EU', '4', 'DL', 'ED', '15', 'ER', 'AP', 'DS', 'BQ', 'AF', 'DS', 'BQ', 'AF', '2', 'EQ', 'DP', 'AP', 'BM', 'AF', 'BM', 'AF']",['633']
708,6,476,566,90,160,34,"['EY', '1', 'AA', '7', 'EQ', 'AP', 'BR', 'AF', 'BM', 'AF', '1', 'AD', 'FA', 'EU', '4', 'DL', 'ED', '15', 'ER', 'AP', 'DS', 'BQ', 'AF', 'DS', 'BQ', 'AF', '2', 'EQ', 'DP', 'AP', 'BM', 'AF', 'BM', 'AF']","['490', '650']"
709,6,477,508,31,0,30,"['EY', '1', 'AA', '7', 'EQ', 'AP', 'BR', 'AF', 'BM', 'AD', 'FA', 'EU', '4', 'DL', 'ED', '15', 'ER', 'AP', 'DS', 'BQ', 'AF', 'DS', 'BQ', 'AF', '2', 'EQ', 'DP', 'AP', 'BM', 'AF']",['636']
710,6,477,498,21,0,32,"['EY', '1', 'AA', '7', 'EQ', 'AP', 'BR', 'AF', 'BM', 'AF', '1', 'AD', 'FA', 'EU', '4', 'DL', 'ED', '15', 'ER', 'AP', 'DS', 'BQ', 'AF', 'DS', 'BQ', 'AF', '2', 'EQ', 'DP', 'AP', 'BM', 'AF']",['635']
711,13,478,520,42,0,34,"['EY', '1', 'AA', '7', 'EQ', 'AP', 'BR', 'AF', 'BM', 'AF', '1', 'AD', 'FA', 'EU', '4', 'DL', 'ED', '15', 'ER', 'AP', 'DS', 'BQ', 'AF', 'DS', 'BQ', 'AF', '2', 'EQ', 'DP', 'AP', 'BM', 'AF', 'BM', 'AF']",['140']
712,13,478,554,76,0,34,"['EY', '1', 'AA', '7', 'EQ', 'AP', 'BR', 'AF', 'BM', 'AF', '1', 'AD', 'FA', 'EU', '4', 'DL', 'ED', '15', 'ER', 'AP', 'DS', 'BQ', 'AF', 'DS', 'BQ', 'AF', '2', 'EQ', 'DP', 'AP', 'BM', 'AF', 'BM', 'AF']",['465']
713,13,478,539,61,0,34,"['EY', '1', 'AA', '7', 'EQ', 'AP', 'BR', 'AF', 'BM', 'AF', '1', 'AD', 'FA', 'EU', '4', 'DL', 'ED', '15', 'ER', 'AP', 'DS', 'BQ', 'AF', 'DS', 'BQ', 'AF', '2', 'EQ', 'DP', 'AP', 'BM', 'AF', 'BM', 'AF']",['464']
714,13,478,635,157,0,34,"['EY', '1', 'AA', '7', 'EQ', 'AP', 'BR', 'AF', 'BM', 'AF', '1', 'AD', 'FA', 'EU', '4', 'DL', 'ED', '15', 'ER', 'AP', 'DS', 'BQ', 'AF', 'DS', 'BQ', 'AF', '2', 'EQ', 'DP', 'AP', 'BM', 'AF', 'BM', 'AF']",['463']
715,13,478,498,20,0,34,"['EY', '1', 'AA', '7', 'EQ', 'AP', 'BR', 'AF', 'BM', 'AF', '1', 'AD', 'FA', 'EU', '4', 'DL', 'ED', '15', 'ER', 'AP', 'DS', 'BQ', 'AF', 'DS', 'BQ', 'AF', '2', 'EQ', 'DP', 'AP', 'BM', 'AF', 'BM', 'AF']",['637']
716,6,479,552,73,0,34,"['EY', '1', 'AA', '7', 'EQ', 'AP', 'BR', 'AF', 'BM', 'AF', '1', 'AD', 'FA', 'EU', '4', 'DL', 'ED', '15', 'ER', 'AP', 'DS', 'BQ', 'AF', 'DS', 'BQ', 'AF', '2', 'EQ', 'DP', 'AP', 'BM', 'AF', 'BM', 'AF']",['148']
717,6,479,493,14,0,34,"['EY', '1', 'AA', '7', 'EQ', 'AP', 'BR', 'AF', 'BM', 'AF', '1', 'AD', 'FA', 'EU', '4', 'DL', 'ED', '15', 'ER', 'AP', 'DS', 'BQ', 'AF', 'DS', 'BQ', 'AF', '2', 'EQ', 'DP', 'AP', 'BM', 'AF', 'BM', 'AF']",['213']
718,6,479,526,47,0,12,"['EY', '1', 'AA', '7', 'EQ', 'AP', 'BR', 'AF', 'BM', 'AF', '1', 'AD']",['334']
719,6,479,493,14,0,34,"['EY', '1', 'AA', '7', 'EQ', 'AP', 'BR', 'AF', 'BM', 'AF', '1', 'AD', 'FA', 'EU', '4', 'DL', 'ED', '15', 'ER', 'AP', 'DS', 'BQ', 'AF', 'DS', 'BQ', 'AF', '2', 'EQ', 'DP', 'AP', 'BM', 'AF', 'BM', 'AF']",['331']
720,6,479,677,198,0,34,"['EY', '1', 'AA', '7', 'EQ', 'AP', 'BR', 'AF', 'BM', 'AF', '1', 'AD', 'FA', 'EU', '4', 'DL', 'ED', '15', 'ER', 'AP', 'DS', 'BQ', 'AF', 'DS', 'BQ', 'AF', '2', 'EQ', 'DP', 'AP', 'BM', 'AF', 'BM', 'AF']",['480']
721,6,479,506,27,0,34,"['EY', '1', 'AA', '7', 'EQ', 'AP', 'BR', 'AF', 'BM', 'AF', '1', 'AD', 'FA', 'EU', '4', 'DL', 'ED', '15', 'ER', 'AP', 'DS', 'BQ', 'AF', 'DS', 'BQ', 'AF', '2', 'EQ', 'DP', 'AP', 'BM', 'AF', 'BM', 'AF']",['478']
722,6,479,493,14,0,34,"['EY', '1', 'AA', '7', 'EQ', 'AP', 'BR', 'AF', 'BM', 'AF', '1', 'AD', 'FA', 'EU', '4', 'DL', 'ED', '15', 'ER', 'AP', 'DS', 'BQ', 'AF', 'DS', 'BQ', 'AF', '2', 'EQ', 'DP', 'AP', 'BM', 'AF', 'BM', 'AF']",['471']
723,12,479,517,38,0,35,"['EY', '1', 'AA', 'AF', '1', 'AD', 'BR', 'AF', 'BM', '41', '7', 'EQ', 'AP', 'FA', 'EU', '4', 'DL', 'ED', '15', 'ER', 'AP', 'DS', 'BQ', 'AF', 'DS', 'ET', 'BA', '2', 'EQ', 'DP', 'AP', 'BM', 'AF', 'BM', 'AF']",['508']
724,6,479,493,14,0,34,"['EY', '1', 'AA', '7', 'EQ', 'AP', 'BR', 'AF', 'BM', 'AF', '1', 'AD', 'FA', 'EU', '2', 'DL', 'ED', '17', 'ER', 'AP', 'DS', 'BQ', 'AF', 'DS', 'BQ', 'AF', '0', 'EQ', 'DP', 'AP', 'BM', 'AF', 'BM', 'AF']",['656']
725,6,479,490,11,0,31,"['EY', '1', 'AA', '7', 'EQ', 'AP', 'BR', 'AF', 'BM', 'AF', '1', 'AD', 'FA', 'EU', '4', 'DL', 'ED', '15', 'ER', 'AP', 'DS', 'BQ', 'AF', 'DS', 'BQ', 'DP', 'AP', 'BM', 'AF', 'BM', 'AF']",['653']
726,6,479,512,33,0,34,"['EY', '1', 'AA', '7', 'EQ', 'AP', 'BR', 'AF', 'BM', 'AF', '1', 'AD', 'FA', 'EU', '4', 'DL', 'ED', '15', 'ER', 'AP', 'DS', 'BQ', 'AF', 'DS', 'BQ', 'AF', '2', 'EQ', 'DP', 'AP', 'BM', 'AF', 'BM', 'AF']",['651']
727,11,480,497,17,0,34,"['EY', '1', 'AA', '7', 'EQ', 'AP', 'BR', 'AF', 'BM', 'AF', '1', 'AD', 'FA', 'EU', '4', 'DL', 'ED', '15', 'ER', 'AP', 'DS', 'BQ', 'AF', 'DS', 'BQ', 'AF', '2', 'EQ', 'DP', 'AP', 'BM', 'AF', 'BM', 'AF']",['336']
728,11,480,515,35,0,34,"['EY', '1', 'AA', '7', 'EQ', 'AP', 'BR', 'AF', 'BQ', 'BM', '-1', 'EM', 'FA', 'EU', '4', 'DL', 'ED', '15', 'ER', 'AP', 'DS', 'BQ', 'AF', 'DS', 'BQ', 'AF', '2', 'EQ', 'DP', 'AP', 'BM', 'AF', 'BM', 'AF']",['659']
729,11,480,622,142,0,34,"['EY', '1', 'AA', '7', 'EQ', 'AP', 'BR', 'AF', 'BM', 'AF', '1', 'AD', 'FA', 'EU', '4', 'DL', 'ED', '15', 'ER', 'AP', 'DS', 'BQ', 'AF', 'DS', 'BQ', 'AF', '2', 'EQ', 'DP', 'AP', 'BM', 'AF', 'BM', 'AF']",['657']
730,11,480,589,109,168,34,"['EY', '1', 'AA', '7', 'EQ', 'AP', 'BR', 'AF', 'BM', 'AF', '1', 'AD', 'FA', 'EU', '4', 'DL', 'ED', '15', 'ER', 'AP', 'DS', 'BQ', 'AF', 'DS', 'BQ', 'AF', '2', 'EQ', 'DP', 'AP', 'BM', 'AF', 'BM', 'AF']","['497', '665']"
731,7,481,536,55,0,31,"['EY', '1', 'AA', 'BR', 'AF', 'BM', 'AF', '1', 'AD', 'FA', 'EU', '4', 'DL', 'ED', '15', 'ER', 'AP', 'DS', 'BQ', 'AF', 'DS', 'BQ', 'AF', '2', 'EQ', 'DP', 'AP', 'BM', 'AF', 'BM', 'AF']",['174']
732,11,483,530,47,0,35,"['EY', '1', 'AA', '7', 'EQ', 'AP', 'BR', 'AF', 'BM', 'AF', '1', 'AD', 'FA', 'EU', '4', 'DL', 'ED', '15', 'ER', 'AP', 'DS', 'BQ', 'AF', 'DS', 'BQ', 'AF', '2', 'EQ', 'DP', 'AP', 'BM', 'AF', 'BM', 'AF', 'FB']",['340']
733,11,483,492,9,0,34,"['EY', '1', 'AA', '7', 'EQ', 'AP', 'BR', 'AF', 'BM', 'AF', '1', 'AD', 'FA', 'EU', '4', 'DL', 'ED', '15', 'ER', 'AP', 'DS', 'BQ', 'AF', 'DS', 'BQ', 'AF', '2', 'EQ', 'DP', 'AP', 'BM', 'AF', 'BM', 'AF']",['337']
734,11,483,535,52,0,34,"['EY', '1', 'AA', '7', 'EQ', 'AP', 'BR', 'AF', 'BM', 'AF', '1', 'AD', 'FA', 'EU', '-4', 'DL', 'ED', '16', 'ER', 'AP', 'DS', 'BQ', 'AF', 'DS', 'BQ', 'AF', '-1', 'EQ', 'DP', 'AP', 'BM', 'AF', 'BM', 'AF']",['496']
735,11,483,497,14,0,34,"['EY', '1', 'AA', '7', 'EQ', 'AP', 'BR', 'AF', 'BM', 'AF', '1', 'AD', 'FA', 'EU', '4', 'DL', 'ED', '15', 'ER', 'AP', 'DS', 'BQ', 'AF', 'DS', 'BQ', 'AF', '2', 'EQ', 'DP', 'AP', 'BM', 'AF', 'BM', 'AF']",['491']
736,11,483,566,83,0,34,"['EY', '1', 'AA', '7', 'EQ', 'AP', 'BR', 'AF', 'BM', 'AF', '1', 'AD', 'FA', 'EU', '4', 'DL', 'ED', '15', 'ER', 'AP', 'DS', 'BQ', 'AF', 'DS', 'BQ', 'AF', '2', 'EQ', 'DP', 'AP', 'BM', 'AF', 'BM', 'AF']",['488']
737,11,483,502,19,0,37,"['EY', '1', 'AA', '7', 'EQ', 'AP', 'BR', 'AF', 'BM', 'AF', '1', 'AD', 'AF', 'BM', 'AF', 'FA', 'EU', '4', 'DL', 'ED', '15', 'ER', 'AP', 'DS', 'BQ', 'AF', 'DS', 'BQ', 'AF', '2', 'EQ', 'DP', 'AP', 'BM', 'AF', 'BM', 'AF']",['667']
738,11,483,517,34,0,34,"['EY', '1', 'AA', '7', 'EQ', 'AP', 'BR', 'AF', 'BM', 'AF', '1', 'AD', 'FA', 'EU', '4', 'DL', 'ED', '15', 'ER', 'AP', 'DS', 'BQ', 'AF', 'DS', 'BQ', 'AF', '2', 'EQ', 'DP', 'AP', 'BM', 'AF', 'BM', 'AF']",['666']
739,11,483,512,29,0,34,"['EY', '1', 'AA', '7', 'EQ', 'AP', 'BR', 'AF', 'BM', 'AF', '1', 'AD', 'FA', 'EU', '4', 'DL', 'ED', '15', 'ER', 'AP', 'DS', 'BQ', 'AF', 'DS', 'BQ', 'AF', '2', 'EQ', 'DP', 'AP', 'BM', 'AF', 'BM', 'AF']",['664']
740,11,483,535,52,0,34,"['EY', '1', 'AA', '7', 'EQ', 'AP', 'BR', 'AF', 'BM', 'AF', '1', 'AD', 'FA', 'EU', '4', 'DL', 'ED', '15', 'ER', 'AP', 'DS', 'BQ', 'AF', 'DS', 'BQ', 'AF', '2', 'EQ', 'DP', 'AP', 'BM', 'AF', 'BM', 'AF']",['663']
741,11,483,586,103,0,34,"['EY', '1', 'AA', '7', 'EQ', 'AP', 'BR', 'AF', 'BM', 'AF', '1', 'AD', 'FA', 'EU', '4', 'DL', 'ED', '15', 'ER', 'AP', 'DS', 'BQ', 'AF', 'DS', 'BQ', 'AF', '2', 'EQ', 'DP', 'AP', 'BM', 'AF', 'BM', 'AF']",['662']
742,4,484,485,1,0,22,"['EY', 'EU', '4', 'DL', 'ED', '15', 'ER', 'AP', 'DS', 'BQ', 'AF', 'DS', 'BQ', 'AF', '2', 'EQ', 'DP', 'AP', 'BM', 'AF', 'BM', 'AF']",['151']
743,4,484,489,5,0,34,"['EY', '1', 'AA', '7', 'EQ', 'AP', 'BR', 'AF', 'BM', 'AF', '1', 'AD', 'FA', 'EU', '4', 'DL', 'ED', '15', 'ER', 'AP', 'DS', 'BQ', 'AF', 'DS', 'BQ', 'AF', '2', 'EQ', 'DP', 'AP', 'BM', 'AF', 'BM', 'AF']",['502']
744,4,484,536,52,0,34,"['EY', '1', 'AA', '7', 'EQ', 'AP', 'BR', 'AF', 'BM', 'AF', '1', 'AD', 'FA', 'EU', '4', 'DL', 'ED', '15', 'ER', 'AP', 'DS', 'BQ', 'BQ', 'DS', 'BQ', 'AF', '2', 'EQ', 'DP', 'AP', 'BM', 'AF', 'BM', 'AF']",['499']
745,16,484,498,14,0,34,"['EY', '1', 'AA', '7', 'EQ', 'AP', 'BR', 'AF', 'BM', 'AF', '1', 'AD', 'FA', 'EU', '4', 'DL', 'ED', '15', 'ER', 'AP', 'DS', 'BQ', 'AF', 'DS', 'BQ', 'AF', '2', 'EQ', 'DP', 'AP', 'BM', 'AF', 'BM', 'AF']",['676']
746,4,484,542,58,0,33,"['EY', '1', 'AA', '7', 'EQ', 'AP', 'BR', 'BM', 'AF', '1', 'AD', 'FA', 'EU', '4', 'DL', 'ED', '15', 'ER', 'AP', 'DS', 'BQ', 'AF', 'DS', 'BQ', 'AF', '2', 'EQ', 'DP', 'AP', 'BM', 'AF', 'BM', 'AF']",['672']
747,9,485,494,9,0,34,"['EY', '1', 'AA', '7', 'EQ', 'AP', 'BR', 'AF', 'BM', 'AF', '1', 'AD', 'FA', 'EU', '4', 'DL', 'ED', '15', 'ER', 'AP', 'DS', 'BQ', 'AF', 'DS', 'BQ', 'AF', '2', 'EQ', 'DP', 'AP', 'BM', 'AF', 'BM', 'AF']",['350']
748,9,485,523,38,195,37,"['EY', '1', 'AA', '7', 'EQ', 'AP', 'BR', 'AF', 'BM', 'AF', '1', 'AD', 'AF', 'BM', 'AF', 'FA', 'EU', '4', 'DL', 'ED', '15', 'ER', 'AP', 'DS', 'BQ', 'AF', 'DS', 'BQ', 'AF', '2', 'EQ', 'DP', 'AP', 'BM', 'AF', 'BM', 'AF']","['162', '357']"
749,9,485,499,14,0,34,"['EY', '1', 'AA', '7', 'EQ', 'AP', 'BR', 'AF', 'BM', 'AF', '1', 'AD', 'FA', 'EU', '4', 'DL', 'ED', '15', 'ER', 'AP', 'DS', 'BQ', 'AF', 'DS', 'BQ', 'AF', '2', 'EQ', 'DP', 'AP', 'BM', 'AF', 'BM', 'AF']",['680']
750,11,486,845,359,4,38,"['EY', '1', 'AA', 'AF', '1', 'AD', 'BR', 'AF', 'BM', '7', 'EQ', 'AP', 'FA', 'EU', '4', 'DL', 'ED', '15', 'ER', 'AP', 'DS', 'BQ', 'AF', 'DS', 'BQ', 'AF', '2', 'EQ', 'DP', 'AP', 'BM', 'AF', 'BM', 'AF', 'FB', '54', '-39', 'AD']","['419', '423']"
751,11,486,529,43,0,34,"['EY', '1', 'AA', '7', 'EQ', 'AP', 'BR', 'AF', 'BM', 'AF', '1', 'AD', 'FA', 'EU', '4', 'DL', 'ED', '15', 'ER', 'AP', 'DS', 'BQ', 'AF', 'DS', 'BQ', 'AF', '2', 'EQ', 'DP', 'AP', 'BM', 'AF', 'BM', 'AF']",['681']
752,16,487,546,59,0,34,"['EY', '1', 'AA', '7', 'EQ', 'AP', 'BR', 'AF', 'BM', 'AF', '1', 'AD', 'FA', 'EU', '4', 'DL', 'ED', '15', 'ER', 'AP', 'DS', 'BQ', 'AF', 'DS', 'BQ', 'AF', '2', 'EQ', 'DP', 'AP', 'BM', 'AF', 'BM', 'AF']",['512']
753,9,487,578,91,0,33,"['EY', '1', 'AA', '7', 'EQ', 'BR', 'AF', 'BM', 'AF', '1', 'AD', 'FA', 'EU', '4', 'DL', 'ED', '15', 'ER', 'AP', 'DS', 'BQ', 'AF', 'DS', 'BQ', 'AF', '2', 'EQ', 'DP', 'AP', 'BM', 'DK', 'BT', 'AF']",['522']
754,10,487,559,72,248,30,"['EY', '1', 'AA', 'AF', '1', 'AD', 'BR', 'AF', 'BM', '7', 'EQ', 'AP', 'FA', 'EU', 'ER', 'AP', 'DS', 'BQ', 'AF', 'DS', 'BQ', 'AF', '2', 'EQ', 'DP', 'AP', 'BM', 'AF', 'BM', 'AF']","['313', '561']"
755,13,487,587,100,0,34,"['EY', '1', 'AA', '7', 'EQ', 'AP', 'BR', 'AF', 'BM', 'AF', '1', 'AD', 'FA', 'EU', '4', 'DL', 'ED', '15', 'ER', 'AP', 'DS', 'BQ', 'AF', 'DS', 'BQ', 'AF', '2', 'EQ', 'DP', 'AP', 'BM', 'AF', 'BM', 'AF']",['686']
756,7,487,548,61,0,34,"['EY', '1', 'AA', 'AF', '1', 'AD', 'BR', 'AF', 'BM', '7', 'EQ', 'AP', 'FA', 'EU', '4', 'DL', 'ED', '15', 'ER', 'AP', 'DS', 'BQ', 'AF', 'DS', 'BQ', 'AF', '2', 'EQ', 'DP', 'AP', 'BM', 'AF', 'BM', 'AF']",['682']
757,7,487,536,49,190,34,"['EY', '1', 'AA', '7', 'EQ', 'AP', 'BR', 'AF', 'BM', 'AF', '1', 'AD', 'FA', 'EU', '4', 'DL', 'ED', '15', 'ER', 'AP', 'DS', 'BQ', 'AF', 'DS', 'BQ', 'AF', '2', 'EQ', 'DP', 'AP', 'BM', 'AF', 'BB', 'AF']","['705', '515']"
758,9,488,597,109,0,34,"['EY', '1', 'AA', '7', 'EQ', 'AP', 'BR', 'AF', 'BM', 'AF', '1', 'AD', 'FA', 'EU', '4', 'DL', 'ED', '15', 'ER', 'AP', 'DS', 'BQ', 'AF', 'DS', 'BQ', 'AF', '2', 'EQ', 'DP', 'AP', 'BM', 'AF', 'BM', 'AF']",['244']
759,9,488,489,1,0,34,"['EY', '1', 'AA', '7', 'EQ', 'AP', 'BR', 'AF', 'BM', 'AF', '1', 'AD', 'FA', 'EU', '4', 'DL', 'ED', '15', 'ER', 'AP', 'DS', 'BQ', 'AF', 'DS', 'BQ', 'AF', '2', 'EQ', 'DP', 'AP', 'BM', 'AF', 'BM', 'AF']",['368']
760,9,488,580,92,0,34,"['EY', '1', 'AA', '7', 'EQ', 'AP', 'BR', 'AF', 'BM', 'AF', '1', 'AD', 'FA', 'EU', '4', 'DL', 'ED', '15', 'ER', 'AP', 'DS', 'BQ', 'AF', 'DS', 'BQ', 'AF', '2', 'EQ', 'DP', 'AP', 'BM', 'AF', 'BM', 'AF']",['366']
761,9,488,502,14,0,34,"['EY', '1', 'AA', '7', 'EQ', 'AP', 'BR', 'AF', 'BM', 'AF', '1', 'AD', 'FA', 'EU', '4', 'DL', 'ED', '15', 'ER', 'AP', 'DS', 'BQ', 'AF', 'DS', 'BQ', 'AF', '2', 'EQ', 'DP', 'AP', 'BM', 'DK', 'BT', 'AF']",['363']
762,9,488,502,14,0,36,"['EY', '1', 'AA', '7', 'EQ', 'AP', 'BR', 'AF', 'BM', 'AF', '1', 'AD', 'FA', 'EU', 'AY', 'DH', '4', 'DL', 'ED', '15', 'ER', 'AP', 'DS', 'BQ', 'AF', 'DS', 'BQ', 'AF', '2', 'EQ', 'DP', 'AP', 'BM', 'AQ', 'BK', 'AI']",['360']
763,9,488,630,142,0,34,"['EY', '1', 'AA', '7', 'EQ', 'AP', 'BR', 'AF', 'BM', 'AF', '1', 'AD', 'FA', 'EU', '4', 'DL', 'ED', '15', 'ER', 'AP', 'DS', 'BQ', 'AF', 'DS', 'BQ', 'AF', '2', 'EQ', 'DP', 'AP', 'BM', 'AF', 'BM', 'AF']",['521']
764,9,488,639,151,0,34,"['EY', '1', 'AA', '7', 'EQ', 'AP', 'BR', 'AF', 'BM', 'AF', '1', 'AD', 'FA', 'EU', '4', 'DL', 'ED', '15', 'ER', 'AP', 'DS', 'BQ', 'AF', 'DS', 'BQ', 'AF', '2', 'EQ', 'DP', 'AP', 'BM', 'AF', 'BM', 'AF']",['520']
765,9,488,621,133,0,34,"['EY', '1', 'AA', '7', 'EQ', 'AP', 'EP', 'EI', 'BM', 'AF', '1', 'AD', 'FA', 'EU', '4', 'DL', 'ED', '15', 'ER', 'AP', 'DS', 'BQ', 'AF', 'DS', 'BQ', 'AF', '2', 'EQ', 'DP', 'AP', 'BM', 'AF', 'BM', 'AF']",['519']
766,9,488,549,61,0,34,"['EY', '1', 'AA', '7', 'EQ', 'AP', 'BR', 'AF', 'BM', 'AF', '1', 'AD', 'FA', 'EU', '4', 'DL', 'ED', '15', 'ER', 'AP', 'DS', 'BQ', 'AF', 'DS', 'BQ', 'AF', '2', 'EQ', 'DP', 'AP', 'BM', 'AF', 'BM', 'AF']",['518']
767,9,488,530,42,0,35,"['EY', '1', 'AA', '7', 'EQ', 'AP', 'BR', 'AF', 'BM', 'AF', '1', 'AD', 'AP', 'FA', 'EU', '4', 'DL', 'ED', '15', 'ER', 'AP', 'DS', 'BQ', 'AF', 'DS', 'BQ', 'AF', '2', 'EQ', 'DP', 'AP', 'BM', 'AF', 'BM', 'AF']",['517']
768,9,488,597,109,0,34,"['EY', '1', 'AA', '7', 'EQ', 'AP', 'BR', 'AF', 'BM', 'AF', '1', 'AD', 'FA', 'EU', '4', 'DL', 'ED', '15', 'ER', 'AP', 'DS', 'BQ', 'AF', 'DS', 'BQ', 'AF', '2', 'EQ', 'DP', 'AP', 'BM', 'AQ', 'BK', 'AI']",['514']
769,9,488,530,42,0,37,"['EY', '1', 'AA', '7', 'EQ', 'AP', 'BR', 'AF', 'BM', 'AF', '1', 'AD', 'AF', 'BM', 'AF', 'FA', 'EU', '4', 'DL', 'ED', '15', 'ER', 'AP', 'DS', 'BQ', 'AF', 'DS', 'BQ', 'AF', '2', 'EQ', 'DP', 'AP', 'BM', 'AF', 'BM', 'AF']",['513']
770,9,488,583,95,0,34,"['EY', '1', 'AA', '7', 'EQ', 'AP', 'BR', 'AF', 'BM', 'AF', '1', 'AD', 'FA', 'EU', '4', 'DL', 'ED', '15', 'ER', 'AP', 'DS', 'BQ', 'AF', 'DS', 'BQ', 'AF', '2', 'EQ', 'DP', 'AP', 'BM', 'AF', 'BM', 'AF']",['702']
771,9,488,580,92,0,34,"['EY', '1', 'AA', '7', 'EQ', 'AP', 'BR', 'AF', 'BM', 'AF', '1', 'AD', 'FA', 'EU', '4', 'DL', 'ED', '15', 'ER', 'AP', 'DS', 'BQ', 'AF', 'DS', 'BQ', 'AF', '2', 'EQ', 'DP', 'AP', 'BM', 'AF', 'BM', 'AF']",['699']
772,9,488,517,29,0,30,"['EY', '1', 'AA', '7', 'EQ', 'AP', '1', 'AD', 'FA', 'EU', '4', 'DL', 'ED', '15', 'ER', 'AP', 'DS', 'BQ', 'AF', 'DS', 'BQ', 'AF', '2', 'EQ', 'DP', 'AP', 'BM', 'AF', 'BM', 'AF']",['697']
773,9,488,593,105,0,34,"['EY', '1', 'AA', '7', 'EQ', 'AP', 'BR', 'AF', 'BM', 'AF', '1', 'AD', 'FA', 'EU', '4', 'DL', 'ED', '15', 'ER', 'AP', 'DS', 'BQ', 'AF', 'DS', 'BQ', 'AF', '2', 'EQ', 'DP', 'AP', 'BM', 'AF', 'BM', 'AF']",['695']
774,9,488,531,43,0,34,"['EY', '1', 'AA', '7', 'EQ', 'AP', 'BR', 'AF', 'BM', 'AF', '1', 'AD', 'FA', 'EU', '4', 'DL', 'ED', '15', 'ER', 'AP', 'DS', 'BQ', 'AF', 'DS', 'BQ', 'AF', '2', 'EQ', 'DP', 'AP', 'BM', 'AF', 'BM', 'AF']",['694']
775,9,488,514,26,0,34,"['EY', '1', 'AA', '7', 'EQ', 'AP', 'BR', 'AF', 'BM', 'AF', '1', 'AD', 'FA', 'EU', '4', 'DL', 'ED', '15', 'ER', 'AP', 'DS', 'BQ', 'AF', 'DS', 'BQ', 'AF', '2', 'EQ', 'DP', 'AP', 'BM', 'DK', 'BT', 'AF']",['693']
776,9,488,522,34,0,30,"['EY', '1', 'AA', '7', 'EQ', 'AP', 'EP', 'EI', 'BM', 'AF', '1', 'AD', 'FA', 'EU', '4', 'DL', 'ED', 'BQ', 'AF', 'DS', 'BQ', 'AF', '2', 'EQ', 'DP', 'AP', 'BM', 'AF', 'BM', 'AF']",['692']
777,9,488,503,15,0,34,"['EY', 'AF', '1', '7', 'EQ', 'AP', 'BR', 'AF', 'BM', '1', 'AA', 'AD', 'FA', 'EU', '4', 'DL', 'ED', '15', 'ER', 'AP', 'DS', 'BQ', 'AF', 'DS', 'BQ', 'AF', '2', 'EQ', 'DP', 'AP', 'BM', 'AF', 'BM', 'AF']",['691']
778,9,488,578,90,0,34,"['EY', '1', 'AA', '7', 'EQ', 'AP', 'BR', 'AF', 'BM', 'AF', '1', 'AD', 'FA', 'EU', '4', 'DL', 'ED', '15', 'ER', 'AP', 'DS', 'BQ', 'AF', 'DS', 'BQ', 'AF', '2', 'EQ', 'DP', 'AP', 'BM', 'AF', 'BM', 'AF']",['690']
779,9,488,559,71,0,34,"['EY', '1', 'AA', '7', 'EQ', 'AP', 'BR', 'AF', 'BM', 'AF', '1', 'AD', 'FA', 'EU', '4', 'DL', 'ED', '15', 'ER', 'AP', 'DS', 'BQ', 'AF', 'DS', 'BQ', 'AF', '2', 'EQ', 'DP', 'AP', 'BM', 'AF', 'BM', 'AF']",['688']
780,9,488,575,87,0,35,"['EY', '1', 'AA', '7', 'EQ', 'AP', 'BR', 'AF', 'BM', 'AF', '1', 'AD', 'FA', 'EU', '4', 'DL', 'ED', '15', 'ER', 'AP', 'DS', 'BQ', 'AF', 'DS', 'BQ', 'AF', '2', 'EQ', 'DP', 'AP', 'BM', 'AF', 'BM', 'AF', 'FB']",['687']
781,14,489,501,12,0,34,"['EY', '1', 'AA', '7', 'EQ', 'AP', 'BR', 'AF', 'BM', 'AF', '1', 'AD', 'FA', 'EU', '4', 'DL', 'ED', '15', 'ER', 'AP', 'DS', 'BQ', 'AF', 'DS', 'BQ', 'AF', '2', 'EQ', 'DP', 'AP', 'BM', 'AF', 'BM', 'AF']",['245']
782,14,489,531,42,0,34,"['EY', '1', 'AA', '7', 'EQ', 'AP', 'BR', 'AF', 'BM', 'AF', '1', 'AD', 'FA', 'EU', '4', 'DL', 'ED', '15', 'ER', 'AP', 'DS', 'BQ', 'AF', 'DS', 'BQ', 'AF', '2', 'EQ', 'DP', 'AP', 'BM', 'AF', 'BM', 'AF']",['524']
783,11,489,504,15,264,35,"['EY', '1', 'AA', 'AF', '1', 'AD', 'BR', 'AF', 'BM', '41', '7', 'EQ', 'AP', 'FA', 'EU', '4', 'DL', 'ED', '15', 'ER', 'AP', 'DS', 'BQ', 'AF', 'DS', 'BQ', 'AF', '2', 'EQ', 'DP', 'AP', 'BM', 'AF', 'BM', 'AF']","['581', '317']"
784,11,489,532,43,0,34,"['EY', '1', 'AA', '7', 'EQ', 'AP', 'BR', 'AF', 'BM', 'AF', '1', 'AD', 'FA', 'EU', '4', 'DL', 'ED', '15', 'ER', 'AP', 'DS', 'BQ', 'AF', 'DS', 'BQ', 'AF', '2', 'EQ', 'DP', 'AP', 'BM', 'AF', 'BM', 'AF']",['704']
785,7,490,493,3,0,22,"['EY', 'EU', '4', 'DL', 'ED', '15', 'ER', 'AP', 'DS', 'BQ', 'AF', 'DS', 'BQ', 'AF', '2', 'EQ', 'DP', 'AP', 'BM', 'AF', 'BM', 'AF']",['220']
786,7,490,493,3,0,34,"['EY', '1', 'AA', '7', 'EQ', 'AP', 'BR', 'AF', 'BM', 'AF', '1', 'AD', 'FA', 'EU', '4', 'DL', 'ED', '15', 'ER', 'AP', 'DS', 'BQ', 'AF', 'DS', 'BQ', 'AF', '2', 'EQ', 'DP', 'AP', 'BM', 'AF', 'BM', 'AF']",['376']
787,10,490,522,32,-290,31,"['EY', '1', 'AA', 'BR', 'AF', 'BM', 'AF', '1', 'AD', 'FA', 'EU', '4', 'DL', 'ED', '15', 'ER', 'AP', 'DS', 'BQ', 'AF', 'DS', 'BQ', 'AF', '2', 'EQ', 'DP', 'AP', 'BM', 'AF', 'BM', 'AF']","['416', '706']"
788,7,490,558,68,0,34,"['EY', '1', 'AA', '7', 'EQ', 'AP', 'BR', 'AF', 'BM', 'AF', '1', 'AD', 'FA', 'EU', '4', 'DL', 'ED', '15', 'ER', 'AP', 'DS', 'BQ', 'AF', 'DS', 'BQ', 'AF', '2', 'EQ', 'DP', 'AP', 'BM', 'AF', 'BM', 'AF']",['526']
789,7,490,503,13,-167,30,"['EY', '1', 'AA', '7', 'EQ', 'AP', 'BR', 'AF', 'BM', 'AD', 'FA', 'EU', '4', 'DL', 'ED', '15', 'ER', 'AP', 'DS', 'BQ', 'AF', 'DS', 'BQ', 'AF', '2', 'EQ', 'DP', 'AP', 'BM', 'AF']","['709', '542']"
790,7,490,507,17,360,34,"['EY', '1', 'AA', '7', 'EQ', 'AP', 'BR', 'AF', 'BM', 'AF', '1', 'AD', 'FA', 'EU', '4', 'DL', 'ED', '15', 'ER', 'AP', 'DS', 'BQ', 'AF', 'DS', 'BQ', 'AF', '2', 'EQ', 'DP', 'AP', 'BM', 'AF', 'BM', 'AF']","['535', '175']"
791,9,490,506,16,0,36,"['EY', '1', 'AA', '7', 'EQ', 'AP', 'BR', 'AF', 'BM', 'AF', '1', 'AD', 'FA', 'EU', '4', 'DL', 'AF', '2', 'ED', '15', 'ER', 'AP', 'DS', 'BQ', 'AF', 'DS', 'BQ', 'AF', '2', 'EQ', 'DP', 'AP', 'BM', 'AF', 'BM', 'AF']",['703']
792,7,490,726,236,0,34,"['EY', '1', 'AA', '7', 'EQ', 'AP', 'BR', 'AF', 'BM', 'AF', '1', 'AD', 'FA', 'EU', '4', 'DL', 'ED', '15', 'ER', 'AP', 'DS', 'BQ', 'AF', 'DS', 'BQ', 'AF', '2', 'EQ', 'DP', 'AP', 'BM', 'AF', 'BM', 'AF']",['708']
793,9,491,672,181,142,34,"['EY', '1', 'AA', '7', 'EQ', 'AP', 'BR', 'AF', 'BM', 'AF', '1', 'AD', 'FA', 'EU', '4', 'DL', 'ED', '15', 'ER', 'AP', 'DS', 'BQ', 'AF', 'DS', 'BQ', 'AF', '2', 'EQ', 'DP', 'AP', 'BM', 'AF', 'BM', 'AF']","['314', '172']"
794,7,491,495,4,0,32,"['EY', '1', 'AA', '7', 'EQ', 'AP', 'BR', 'AF', 'BM', 'AF', '1', 'AD', 'FA', 'EU', '4', 'DL', 'ED', '15', 'ER', 'AP', 'DS', 'BQ', 'AF', 'DS', 'BQ', 'AF', '2', 'EQ', 'DP', 'AP', 'BM', 'AF']",['710']
795,14,492,526,34,0,34,"['EY', '1', 'AA', '7', 'EQ', 'AP', 'BR', 'AF', 'BM', 'AF', '1', 'AD', 'FA', 'EU', '4', 'DL', 'ED', '15', 'ER', 'AP', 'DS', 'BQ', 'AF', 'DS', 'BQ', 'AF', '2', 'EQ', 'DP', 'AP', 'BM', 'AF', 'BM', 'AF']",['166']
796,14,492,525,33,0,32,"['EY', '1', 'AA', '7', 'EQ', 'AP', 'BR', 'AF', 'BM', 'AF', '1', 'AD', 'FA', 'EU', '4', 'DL', 'ED', 'AP', 'DS', 'BQ', 'AF', 'DS', 'BQ', 'AF', '2', 'EQ', 'DP', 'AP', 'BM', 'AF', 'BM', 'AF']",['714']
797,14,492,497,5,0,31,"['EY', '1', 'AP', 'BR', 'AF', 'BM', 'AF', '1', 'AD', 'FA', 'EU', '4', 'DL', 'ED', '15', 'ER', 'AP', 'DS', 'BQ', 'AF', 'DS', 'BQ', 'AF', '2', 'EQ', 'DP', 'AP', 'BM', 'AF', 'BM', 'AF']",['713']
798,14,492,525,33,0,34,"['EY', '1', 'AA', '7', 'EQ', 'AP', 'BR', 'AF', 'BM', 'AF', '1', 'AD', 'FA', 'EU', '4', 'DL', 'ED', '15', 'ER', 'AP', 'DS', 'BQ', 'AF', 'DS', 'BQ', 'AF', '2', 'EQ', 'DP', 'AP', 'BM', 'AF', 'BM', 'AF']",['712']
799,7,493,512,19,0,34,"['EY', '1', 'AA', '7', 'EQ', 'AP', 'BR', 'AF', 'BM', 'AF', '1', 'AD', 'FA', 'EU', '4', 'DL', 'ED', '15', 'ER', 'AP', 'DS', 'BQ', 'AF', 'DS', 'BQ', 'AF', '2', 'EQ', 'DP', 'AP', 'BM', 'DK', 'BT', 'AF']",['259']
800,7,493,494,1,0,34,"['EY', '1', 'AA', '7', 'EQ', 'AP', 'BR', 'AF', 'BM', 'AF', '1', 'AD', 'FA', 'EU', '4', 'DL', 'ED', '15', 'ER', 'AP', 'DS', 'BQ', 'AF', 'DS', 'BQ', 'AF', '2', 'EQ', 'DP', 'AP', 'BM', 'AF', 'BM', 'AF']",['383']
801,7,493,588,95,0,34,"['EY', '1', 'AA', '7', 'EQ', 'AP', 'BR', 'AF', 'BM', 'AF', '1', 'AD', 'FA', 'EU', '4', 'DL', 'ED', '15', 'ER', 'AP', 'DS', 'BQ', 'AF', 'DS', 'BQ', 'AF', '2', 'EQ', 'DP', 'AP', 'BM', 'AF', 'BM', 'AF']",['548']
802,7,493,507,14,0,34,"['EY', '1', 'AA', '7', 'EQ', 'AP', 'BR', 'AF', 'BM', 'AF', '1', 'AD', 'FA', 'EU', '4', 'DL', 'ED', '15', 'ER', 'AP', 'DS', 'BQ', 'AF', 'DS', 'BQ', 'AF', '2', 'EQ', 'DP', 'AP', 'BM', 'AF', 'BM', 'AF']",['546']
803,7,493,543,50,0,34,"['EY', '1', 'AA', '7', 'EQ', 'AP', 'BR', 'AF', 'BM', 'AF', '1', 'AD', 'FA', 'EU', '4', 'DL', 'ED', '15', 'ER', 'AP', 'DS', 'BQ', 'AF', 'DS', 'BQ', 'AF', '2', 'EQ', 'DP', 'AP', 'BM', 'AF', 'BM', 'AF']",['543']
804,7,493,616,123,0,34,"['EY', '1', 'AA', '7', 'EQ', 'AP', 'BR', 'AF', 'BM', 'AF', '1', 'AD', 'FA', 'EU', '4', 'DL', 'ED', '15', 'ER', 'AP', 'DS', 'BQ', 'AF', 'DS', 'BQ', 'AF', '2', 'EQ', 'DP', 'AP', 'BM', 'AF', 'BM', 'AF']",['541']
805,7,493,540,47,0,34,"['EY', '1', 'AA', '7', 'EQ', 'AP', 'BR', 'AF', 'BM', 'AF', '1', 'AD', 'FA', 'EU', '4', 'DL', 'ED', '15', 'ER', 'AP', 'DS', 'BQ', 'AF', 'DS', 'BQ', 'AF', '2', 'EQ', 'DP', 'AP', 'BM', 'AF', 'BM', 'AF']",['539']
806,7,493,748,255,0,34,"['EY', '1', 'AA', '7', 'EQ', 'AP', 'BR', 'AF', 'BM', 'AF', '1', 'AD', 'FA', 'EU', '4', 'DL', 'ED', '15', 'ER', 'AP', 'DS', 'BQ', 'AF', 'DS', 'BQ', 'AF', '2', 'EQ', 'DP', 'AP', 'BM', 'AF', 'BM', 'AF']",['538']
807,7,493,654,161,0,37,"['EY', '1', 'AA', '7', 'EQ', 'AP', 'BR', 'AF', 'BM', 'AF', '1', 'AD', 'FA', 'DA', 'BD', 'BJ', 'EU', '4', 'DL', 'ED', '15', 'ER', 'AP', 'DS', 'BQ', 'AF', 'DS', 'BQ', 'AF', '2', 'EQ', 'DP', 'AP', 'BM', 'AF', 'BM', 'AF']",['707']
808,7,493,573,80,0,34,"['EY', '1', 'AA', '7', 'EQ', 'AP', 'BR', 'AF', 'BM', 'AF', '1', 'AD', 'FA', 'EU', '2', 'DL', 'ED', '17', 'ER', 'AP', 'DS', 'BQ', 'AF', 'DS', 'BQ', 'AF', '0', 'EQ', 'DP', 'AP', 'BM', 'AF', 'BM', 'AF']",['724']
809,7,493,584,91,0,34,"['EY', '1', 'AA', '7', 'EQ', 'AP', 'BR', 'AF', 'BM', 'AF', '1', 'AD', 'FA', 'EU', '4', 'DL', 'ED', '15', 'ER', 'AP', 'DS', 'BQ', 'AF', 'DS', 'BQ', 'AF', '2', 'EQ', 'DP', 'AP', 'BM', 'AF', 'BM', 'AF']",['721']
810,7,493,526,33,0,34,"['EY', '1', 'AA', '7', 'EQ', 'AP', 'BR', 'AF', 'BM', 'AF', '1', 'AD', 'FA', 'EU', '4', 'DL', 'ED', '15', 'ER', 'AP', 'DS', 'BQ', 'AF', 'DS', 'BQ', 'AF', '2', 'EQ', 'DP', 'AP', 'BM', 'AF', 'BM', 'AF']",['720']
811,7,493,569,76,0,36,"['EY', '1', 'AA', '7', 'EQ', 'AP', 'BR', '1', 'AD', 'AF', 'BM', 'AF', '1', 'AD', 'FA', 'EU', '4', 'DL', 'ED', '15', 'ER', 'AP', 'DS', 'BQ', 'AF', 'DS', 'BQ', 'AF', '2', 'EQ', 'DP', 'AP', 'BM', 'AF', 'BM', 'AF']",['716']
812,12,494,570,76,0,34,"['EY', '1', 'AA', '7', 'EQ', 'AP', 'BR', 'AF', 'BM', 'AF', '1', 'AD', 'FA', 'EU', '4', 'DL', 'ED', '15', 'ER', 'AP', 'DS', 'BQ', 'AF', 'DS', 'BQ', 'AF', '2', 'EQ', 'DP', 'AP', 'BM', 'AF', 'BM', 'AF']",['395']
813,5,494,673,179,0,32,"['EY', '1', 'AA', '7', 'EQ', 'AP', 'BR', 'AF', 'BM', 'AF', '1', 'AD', 'FA', 'EU', '4', 'DL', 'ED', '15', 'ER', 'AP', 'DS', 'BQ', 'AF', 'DS', 'BQ', 'AF', '2', 'EQ', 'DP', 'AP', 'BM', 'AF']",['412']
814,12,494,502,8,0,34,"['EY', '1', 'AA', '7', 'EQ', 'AP', 'BR', 'AF', 'BM', 'AF', '1', 'AD', 'FA', 'EU', '4', 'DL', 'ED', '15', 'ER', 'AP', 'DS', 'BQ', 'AF', 'DS', 'BQ', 'AF', '2', 'EQ', 'DP', 'AP', 'BM', 'AF', 'DM', 'BF']",['553']
815,12,494,646,152,0,33,"['EY', '1', 'AA', '7', 'EQ', 'BR', 'AF', 'BM', 'AF', '1', 'AD', 'FA', 'EU', '4', 'DL', 'ED', '15', 'ER', 'AP', 'DS', 'BQ', 'AF', 'DS', 'BQ', 'AF', '2', 'EQ', 'DP', 'AP', 'BM', 'AF', 'BM', 'AF']",['730']
816,12,494,556,62,0,34,"['EY', '1', 'AA', '7', 'EQ', 'AP', 'BR', 'AF', 'BM', 'AF', '1', 'AD', 'FA', 'EU', '4', 'DL', 'ED', '15', 'ER', 'AP', 'DS', 'BQ', 'AF', 'DS', 'BQ', 'AF', '2', 'EQ', 'DP', 'AP', 'BM', 'AF', 'BM', 'AF']",['727']
817,5,495,564,69,0,34,"['EY', '1', 'AA', '7', 'EQ', 'AP', 'BR', 'AF', 'BM', 'AF', '1', 'AD', 'FA', 'EU', '4', 'DL', 'ED', '15', 'ER', 'AP', 'DS', 'BQ', 'AF', 'DS', 'BQ', 'AF', '2', 'EQ', 'DP', 'AP', 'BM', 'AF', 'BM', 'AF']",['267']
818,7,495,497,2,0,36,"['EY', '1', 'AA', '7', 'EQ', 'BR', 'AF', 'AP', 'BR', 'AF', 'BM', 'AF', '1', 'AD', 'FA', 'EU', '4', 'DL', 'ED', '15', 'ER', 'AP', 'DS', 'BQ', 'AF', 'DS', 'BQ', 'AF', '2', 'EQ', 'DP', 'AP', 'BM', 'AF', 'BM', 'AF']",['537']
819,5,495,582,87,50,36,"['EY', '1', 'AA', '7', 'EQ', 'BR', 'AF', 'AP', 'BR', 'AF', 'BM', 'AF', '1', 'AD', 'FA', 'EU', '4', 'DL', 'ED', '15', 'ER', 'AP', 'DS', 'BQ', 'AF', 'DS', 'BQ', 'AF', '2', 'EQ', 'DP', 'AP', 'BM', 'AF', 'BM', 'AF']","['696', '746']"
820,5,496,498,2,0,32,"['EY', '1', 'AA', '7', 'EQ', 'AP', 'BR', 'AF', 'BM', 'AF', '1', 'AD', 'FA', 'EU', '4', 'DL', 'ED', '15', 'DS', 'BQ', 'BQ', 'DS', 'BQ', 'AF', '2', 'EQ', 'DP', 'AP', 'BM', 'AF', 'BM', 'AF']",['744']
821,12,497,563,66,0,34,"['EY', '1', 'AA', '7', 'EQ', 'AP', 'BR', 'AF', 'BM', 'AF', '1', 'AD', 'FA', 'EU', '4', 'DL', 'ED', '15', 'ER', 'AP', 'DS', 'BQ', 'AF', 'DS', 'BQ', 'AF', '2', 'EQ', 'DP', 'AP', 'BM', 'AF', 'BM', 'AF']",['54']
822,12,497,603,106,0,37,"['EY', '1', 'AA', '7', 'EQ', 'AP', 'BR', 'AF', 'BM', 'AF', '1', 'AD', 'AF', 'BM', 'AF', 'FA', 'EU', '4', 'DL', 'ED', '15', 'ER', 'AP', 'DS', 'BQ', 'AF', 'DS', 'BQ', 'AF', '2', 'EQ', 'DP', 'AP', 'BM', 'AF', 'BM', 'AF']",['398']
823,12,497,558,61,0,34,"['EY', '1', 'AA', '7', 'EQ', 'AP', 'BR', 'AF', 'BM', 'AF', '1', 'AD', 'FA', 'EU', '4', 'DL', 'ED', '15', 'ER', 'AP', 'DS', 'BQ', 'AF', 'DS', 'BQ', 'AF', '2', 'EQ', 'DP', 'AP', 'BM', 'AF', 'BM', 'AF']",['577']
824,12,497,525,28,0,34,"['EY', '1', 'AA', '7', 'EQ', 'AP', 'BR', 'AF', 'BM', 'AF', '1', 'AD', 'FA', 'EU', '4', 'DL', 'ED', '15', 'ER', 'AP', 'DS', 'BQ', 'AF', 'DS', 'BQ', 'AF', '2', 'EQ', 'DP', 'AP', 'BM', 'AF', 'BM', 'AF']",['576']
825,12,497,606,109,0,34,"['EY', '1', 'AA', '7', 'EQ', 'AP', 'BR', 'AF', 'BM', 'AF', '1', 'AD', 'FA', 'EU', '4', 'DL', 'ED', '15', 'ER', 'AP', 'DS', 'BQ', 'AF', 'DS', 'BQ', 'AF', '2', 'EQ', 'DP', 'AP', 'BM', 'AF', 'BM', 'AF']",['573']
826,12,497,498,1,0,34,"['EY', '1', 'AA', '7', 'EQ', 'AP', 'BR', 'AF', 'BM', 'AF', '1', 'AD', 'FA', 'EU', '4', 'DL', 'ED', '15', 'ER', 'AP', 'DS', 'BQ', 'AF', 'DS', 'BQ', 'AF', '2', 'EQ', 'DP', 'AP', 'BM', 'AF', 'BM', 'AF']",['570']
827,12,497,535,38,0,34,"['EY', '1', 'AA', '7', 'EQ', 'AP', 'BR', 'AF', 'BM', 'AF', '1', 'AD', 'FA', 'EU', '4', 'DL', 'ED', '15', 'ER', 'AP', 'DS', 'BQ', 'AF', 'DS', 'BQ', 'AF', '2', 'EQ', 'DP', 'AP', 'BM', 'AF', 'BM', 'AF']",['567']
828,12,497,582,85,0,34,"['EY', '1', 'AA', '7', 'EQ', 'AP', 'BR', 'AF', 'BM', 'AF', '1', 'AD', 'FA', 'EU', '4', 'DL', 'ED', '15', 'ER', 'AP', 'DS', 'BQ', 'AF', 'DS', 'BQ', 'AF', '2', 'EQ', 'DP', 'AP', 'BM', 'AF', 'BM', 'AF']",['741']
829,12,497,511,14,0,34,"['EY', '1', 'AA', '7', 'EQ', 'AP', 'BR', 'AF', 'BM', 'AF', '1', 'AD', 'FA', 'EU', '4', 'DL', 'ED', '15', 'ER', 'AP', 'DS', 'BQ', 'AF', 'DS', 'BQ', 'AF', '2', 'EQ', 'DP', 'AP', 'BM', 'AF', 'BM', 'AF']",['740']
830,12,497,720,223,0,34,"['EY', '1', 'AA', '7', 'EQ', 'AP', 'BR', 'AF', 'BM', 'AF', '1', 'AD', 'FA', 'EU', '4', 'DL', 'ED', '15', 'ER', 'AP', 'DS', 'BQ', 'AF', 'DS', 'BQ', 'AF', '2', 'EQ', 'DP', 'AP', 'BM', 'AF', 'BM', 'AF']",['739']
831,12,497,498,1,0,37,"['EY', '1', 'AA', '7', 'EQ', 'AP', 'BR', 'AF', 'BM', 'AF', '1', 'AD', 'AF', 'BM', 'AF', 'FA', 'EU', '4', 'DL', 'ED', '15', 'ER', 'AP', 'DS', 'BQ', 'AF', 'DS', 'BQ', 'AF', '2', 'EQ', 'DP', 'AP', 'BM', 'AF', 'BM', 'AF']",['737']
832,12,497,512,15,0,34,"['EY', '1', 'AA', '7', 'EQ', 'AP', 'BR', 'AF', 'BM', 'AF', '1', 'AD', 'FA', 'EU', '4', 'DL', 'ED', '15', 'ER', 'AP', 'DS', 'BQ', 'AF', 'DS', 'BQ', 'AF', '2', 'EQ', 'DP', 'AP', 'BM', 'AF', 'BM', 'AF']",['736']
833,12,497,611,114,0,35,"['EY', '1', 'AA', '7', 'EQ', 'AP', 'BR', 'AF', 'BM', 'AF', '1', 'AD', 'FA', 'EU', '4', 'DL', 'ED', '15', 'ER', 'AP', 'DS', 'BQ', 'AF', 'DS', 'BQ', 'AF', '2', 'EQ', 'DP', 'AP', 'BM', 'AF', 'BM', 'AF', 'FB']",['732']
834,5,498,512,14,0,33,"['EY', '1', 'AA', '7', 'EQ', 'BR', 'AF', 'BM', 'AF', '1', 'AD', 'FA', 'EU', '4', 'DL', 'ED', '15', 'ER', 'AP', 'DS', 'BQ', 'AF', 'DS', 'BQ', 'AF', '2', 'EQ', 'DP', 'AP', 'BM', 'AF', 'BM', 'AF']",['181']
835,5,498,521,23,0,34,"['EY', '1', 'AA', '7', 'EQ', 'AP', 'BR', 'AF', 'BM', 'AF', '1', 'AD', 'FA', 'EU', '4', 'DL', 'ED', '15', 'ER', 'AP', 'DS', 'BQ', 'AF', 'DS', 'BQ', 'AF', '2', 'EQ', 'DP', 'AP', 'BM', 'AF', 'BM', 'AF']",['281']
836,5,498,616,118,0,34,"['EY', '1', 'AA', '7', 'EQ', 'AP', 'BR', 'AF', 'BM', 'AF', '1', 'AD', 'FA', 'EU', '4', 'DL', 'ED', '15', 'ER', 'AP', 'DS', 'BQ', 'AF', 'DS', 'BQ', 'AF', '2', 'EQ', 'DP', 'AP', 'BM', 'AF', 'BM', 'AF']",['404']
837,5,498,583,85,0,34,"['EY', '1', 'AA', '7', 'EQ', 'AP', 'BR', 'AF', 'BM', 'AF', '1', 'AD', 'FA', 'EU', '4', 'DL', 'ED', '15', 'ER', 'AP', 'DS', 'BQ', 'AF', 'DS', 'BQ', 'AF', '2', 'EQ', 'DP', 'AP', 'BM', 'AF', 'BM', 'AF']",['579']
838,5,498,509,11,0,34,"['EY', '1', 'AA', '7', 'EQ', 'AP', 'BR', 'AF', 'BM', 'AF', '1', 'AD', 'FA', 'EU', '4', 'DL', 'ED', '15', 'ER', 'AP', 'DS', 'BQ', 'AF', 'DS', 'BQ', 'AF', '2', 'EQ', 'DP', 'AP', 'BM', 'AF', 'BM', 'AF']",['578']
839,10,499,516,17,0,34,"['EY', '1', 'AA', '7', 'EQ', 'AP', 'BR', 'AF', 'BM', 'AF', '1', 'AD', 'FA', 'EU', '4', 'DL', 'ED', '15', 'ER', 'AP', 'DS', 'BQ', 'AF', 'DS', 'BQ', 'AF', '2', 'EQ', 'DP', 'AP', 'BM', 'AF', 'BM', 'AF']",['588']
840,10,499,516,17,-144,37,"['EY', '1', 'AA', '7', 'EQ', 'AP', 'BR', 'AF', 'BM', 'AF', '1', 'AD', 'AF', 'BM', 'AF', 'FA', 'EU', '4', 'DL', 'ED', '15', 'ER', 'AP', 'DS', 'BQ', 'AF', 'DS', 'BQ', 'AF', '2', 'EQ', 'DP', 'AP', 'BM', 'AF', 'BM', 'AF']","['748', '604']"
841,10,499,542,43,161,34,"['EY', '1', 'AA', '7', 'EQ', 'AP', 'BR', 'AF', 'BM', 'AF', '1', 'AD', 'FA', 'EU', '4', 'DL', 'ED', '15', 'ER', 'AP', 'DS', 'BQ', 'AF', 'DS', 'BQ', 'AF', '2', 'EQ', 'DP', 'AP', 'BM', 'DK', 'BT', 'AF']","['600', '761']"
842,3,500,504,4,-401,34,"['EY', '1', 'AA', '7', 'EQ', 'AP', 'BR', 'AF', 'BM', 'AF', '1', 'AD', 'FA', 'EU', '4', 'DL', 'ED', '15', 'ER', 'AP', 'DS', 'BQ', 'AF', 'DS', 'BQ', 'AF', '2', 'EQ', 'DP', 'AP', 'BM', 'AF', 'BM', 'AF']","['193', '594']"
843,10,500,549,49,-174,35,"['EY', '1', 'AA', '7', 'ES', 'EQ', 'AP', 'BR', 'AF', 'BM', 'AF', '1', 'AD', 'FA', 'EU', '4', 'DL', 'ED', '15', 'ER', 'AP', 'DS', 'BQ', 'AF', 'DS', 'BQ', 'AF', '2', 'EQ', 'DP', 'AP', 'BM', 'AF', 'BM', 'AF']","['593', '767']"
844,12,500,546,46,0,34,"['EY', '1', 'AA', '7', 'EQ', 'AP', 'BR', 'AF', 'BM', 'AF', '1', 'AD', 'FA', 'EU', '4', 'DL', 'ED', '15', 'ER', 'AP', 'DS', 'BQ', 'AF', 'DS', 'BQ', 'AF', '2', 'EQ', 'DP', 'AP', 'BM', 'AF', 'BM', 'AF']",['751']
845,8,501,559,58,-294,34,"['EY', '1', 'AA', 'AF', '1', 'AD', 'BR', 'AF', 'BM', '7', 'EQ', 'AP', 'FA', 'EU', '4', 'DL', 'ED', '15', 'ER', 'AP', 'DS', 'BQ', 'AF', 'DS', 'BQ', 'AF', '2', 'EQ', 'DP', 'AP', 'BM', 'AF', 'BM', 'AF']","['481', '187']"
846,17,501,719,218,0,34,"['EY', '1', 'AA', '7', 'EQ', 'AP', 'BR', 'AF', 'BM', 'AF', '1', 'AD', 'FA', 'EU', '4', 'DL', 'ED', '15', 'ER', 'AP', 'DS', 'BQ', 'AF', 'DS', 'BQ', 'AF', '2', 'EQ', 'DP', 'AP', 'BM', 'AF', 'BM', 'AF']",['590']
847,8,501,503,2,0,30,"['EY', '1', 'AA', '7', 'EQ', 'AP', 'BR', 'AF', 'BM', 'AF', '1', 'AD', 'FA', 'EU', '4', 'DL', 'ED', '15', 'ER', 'AP', 'DS', 'BQ', 'AF', 'DS', 'BQ', 'AF', '2', 'EQ', 'DP', 'AF']",['757']
848,14,501,515,14,0,34,"['EY', '1', 'AA', '7', 'EQ', 'AP', 'BR', 'AF', 'BM', 'AF', '1', 'AD', 'FA', 'EU', '4', 'DL', 'ED', '15', 'ER', 'AP', 'DS', 'BQ', 'AF', 'DS', 'BQ', 'AF', '2', 'EQ', 'DP', 'AP', 'BM', 'AF', 'BM', 'AF']",['755']
849,17,501,515,14,0,34,"['EY', '1', 'AA', '7', 'EQ', 'AP', 'BR', 'AF', 'BM', 'AF', '1', 'AD', 'FA', 'EU', '4', 'DL', 'ED', '15', 'ER', 'AP', 'DS', 'BQ', 'AF', 'DS', 'BQ', 'AF', '2', 'EQ', 'DP', 'AP', 'BM', 'AF', 'BM', 'AF']",['752']
850,10,502,607,105,0,32,"['EY', '1', 'AA', 'AP', 'BR', 'AF', 'BM', 'AF', '1', 'AD', 'FA', 'EU', '4', 'DL', 'ED', '15', 'ER', 'AP', 'DS', 'BQ', 'AF', 'DS', 'BQ', 'AF', '2', 'EQ', 'DP', 'AP', 'BM', 'AF', 'BM', 'AF']",['188']
851,10,502,550,48,0,34,"['EY', '1', 'AA', '7', 'EQ', 'AP', 'BR', 'AF', 'BM', 'AF', '1', 'AD', 'FA', 'EU', '4', 'DL', 'ED', '15', 'ER', 'AP', 'DS', 'BQ', 'AF', 'DS', 'BQ', 'AF', '2', 'EQ', 'DP', 'AP', 'BM', 'AF', 'BM', 'AF']",['427']
852,10,502,525,23,431,33,"['EY', 'EU', '4', 'DL', 'ED', '15', 'ER', 'AP', 'DS', 'BQ', 'AF', 'DS', 'BQ', 'AF', '2', 'EQ', 'DP', 'AP', 'BM', 'AF', 'BM', 'AF', 'FA', 'AA', '7', 'EQ', 'AP', 'BR', 'AF', 'BM', 'AF', '1', 'AD']","['500', '69']"
853,10,502,766,264,0,34,"['EY', '1', 'AA', '7', 'EQ', 'AP', 'BR', 'AF', 'BM', 'AF', '1', 'AD', 'FA', 'EU', '4', 'DL', 'ED', '15', 'ER', 'AP', 'DS', 'BQ', 'AF', 'DS', 'BQ', 'AF', '2', 'EQ', 'DP', 'AP', 'BM', 'AF', 'BM', 'AF']",['602']
854,10,502,535,33,0,34,"['EY', '1', 'AA', '7', 'EQ', 'AP', 'BR', 'AF', 'BM', 'AF', '1', 'AD', 'FA', 'EU', '4', 'DL', 'ED', '15', 'ER', 'AP', 'DS', 'BQ', 'AF', 'DS', 'BQ', 'AF', '2', 'EQ', 'DP', 'AP', 'BM', 'AF', 'BM', 'AF']",['591']
855,10,502,558,56,0,35,"['EY', '1', 'AA', '7', 'EQ', 'AP', 'BR', 'AF', 'BM', 'AF', '1', 'AD', 'FA', 'EU', '4', 'DL', 'ED', '15', 'ER', 'AP', 'DS', 'BQ', 'AF', 'DS', 'BQ', 'AF', '2', 'EQ', 'DP', 'AP', 'BM', 'AF', 'BM', 'AF', 'FB']",['780']
856,10,502,549,47,0,34,"['EY', '1', 'AA', '7', 'EQ', 'AP', 'BR', 'AF', 'BM', 'AF', '1', 'AD', 'FA', 'EU', '4', 'DL', 'ED', '15', 'ER', 'AP', 'DS', 'BQ', 'AF', 'DS', 'BQ', 'AF', '2', 'EQ', 'DP', 'AP', 'BM', 'AF', 'BM', 'AF']",['779']
857,10,502,568,66,0,34,"['EY', '1', 'AA', '7', 'EQ', 'AP', 'BR', 'AF', 'BM', 'AF', '1', 'AD', 'FA', 'EU', '4', 'DL', 'ED', '15', 'ER', 'AP', 'DS', 'BQ', 'AF', 'DS', 'BQ', 'AF', '2', 'EQ', 'DP', 'AP', 'BM', 'AF', 'BM', 'AF']",['778']
858,10,502,545,43,0,34,"['EY', '1', 'AA', '7', 'EQ', 'AP', 'BR', 'AF', 'BM', 'AF', '1', 'AD', 'FA', 'EU', '4', 'DL', 'ED', '15', 'ER', 'AP', 'DS', 'BQ', 'AF', 'DS', 'BQ', 'AF', '2', 'EQ', 'DP', 'AP', 'BM', 'DK', 'BT', 'AF']",['775']
859,10,502,631,129,0,34,"['EY', '1', 'AA', '7', 'EQ', 'AP', 'BR', 'AF', 'BM', 'AF', '1', 'AD', 'FA', 'EU', '4', 'DL', 'ED', '15', 'ER', 'AP', 'DS', 'BQ', 'AF', 'DS', 'BQ', 'AF', '2', 'EQ', 'DP', 'AP', 'BM', 'AF', 'BM', 'AF']",['774']
860,10,502,516,14,0,34,"['EY', '1', 'AA', '7', 'EQ', 'AP', 'BR', 'AF', 'BM', 'AF', '1', 'AD', 'FA', 'EU', '4', 'DL', 'ED', '15', 'ER', 'AP', 'DS', 'BQ', 'AF', 'DS', 'BQ', 'AF', '2', 'EQ', 'DP', 'AP', 'BM', 'AF', 'BM', 'AF']",['773']
861,10,502,530,28,0,30,"['EY', '1', 'AA', '7', 'EQ', 'AP', '1', 'AD', 'FA', 'EU', '4', 'DL', 'ED', '15', 'ER', 'AP', 'DS', 'BQ', 'AF', 'DS', 'BQ', 'AF', '2', 'EQ', 'DP', 'AP', 'BM', 'AF', 'BM', 'AF']",['772']
862,10,502,649,147,0,34,"['EY', '1', 'AA', '7', 'EQ', 'AP', 'BR', 'AF', 'BM', 'AF', '1', 'AD', 'FA', 'EU', '4', 'DL', 'ED', '15', 'ER', 'AP', 'DS', 'BQ', 'AF', 'DS', 'BQ', 'AF', '2', 'EQ', 'DP', 'AP', 'BM', 'AF', 'BM', 'AF']",['771']
863,10,502,540,38,0,34,"['EY', '1', 'AA', '7', 'EQ', 'AP', 'BR', 'AF', 'BM', 'AF', '1', 'AD', 'FA', 'EU', '4', 'DL', 'ED', '15', 'ER', 'AP', 'DS', 'BQ', 'AF', 'DS', 'BQ', 'AF', '2', 'EQ', 'DP', 'AP', 'BM', 'AF', 'BM', 'AF']",['770']
864,10,502,516,14,0,34,"['EY', '1', 'AA', '7', 'EQ', 'AP', 'BR', 'AF', 'BM', 'AF', '1', 'AD', 'FA', 'EU', '4', 'DL', 'ED', '15', 'ER', 'AP', 'DS', 'BQ', 'AF', 'DS', 'BQ', 'AF', '2', 'EQ', 'DP', 'AP', 'BM', 'AQ', 'BK', 'AI']",['768']
865,10,502,516,14,0,34,"['EY', '1', 'AA', '7', 'EQ', 'AP', 'BR', 'AF', 'BM', 'AF', '1', 'AD', 'FA', 'EU', '4', 'DL', 'ED', '15', 'ER', 'AP', 'DS', 'BQ', 'AF', 'DS', 'BQ', 'AF', '2', 'EQ', 'DP', 'AP', 'BM', 'AF', 'BM', 'AF']",['764']
866,10,502,587,85,0,34,"['EY', '1', 'AA', '7', 'EQ', 'AP', 'BR', 'AF', 'BM', 'AF', '1', 'AD', 'FA', 'EU', '4', 'DL', 'ED', '15', 'ER', 'AP', 'DS', 'BQ', 'AF', 'DS', 'BQ', 'AF', '2', 'EQ', 'DP', 'AP', 'BM', 'AF', 'BM', 'AF']",['760']
867,10,502,769,267,0,34,"['EY', '1', 'AA', '7', 'EQ', 'AP', 'BR', 'AF', 'BM', 'AF', '1', 'AD', 'FA', 'EU', '4', 'DL', 'ED', '15', 'ER', 'AP', 'DS', 'BQ', 'AF', 'DS', 'BQ', 'AF', '2', 'EQ', 'DP', 'AP', 'BM', 'AF', 'BM', 'AF']",['758']
868,10,502,578,76,3,34,"['EY', '1', 'AA', '7', 'EQ', 'AP', 'BR', 'AF', 'BM', 'AF', '1', 'AD', 'FA', 'EU', '4', 'DL', 'ED', '15', 'ER', 'AP', 'DS', 'BQ', 'AF', 'DS', 'BQ', 'AF', '2', 'EQ', 'DP', 'AP', 'BM', 'AF', 'BM', 'AF']","['793', '790']"
869,3,503,512,9,0,34,"['EY', '1', 'AA', '7', 'EQ', 'AP', 'BR', 'AF', 'BM', 'AF', '1', 'AD', 'FA', 'EU', '4', 'DL', 'ED', '15', 'ER', 'AP', 'DS', 'BQ', 'AF', 'DS', 'BQ', 'AF', '2', 'EQ', 'DP', 'AP', 'BM', 'AF', 'BM', 'AF']",['64']
870,3,503,531,28,0,34,"['EY', '1', 'AA', '7', 'EQ', 'AP', 'BR', 'AF', 'BM', 'AF', '1', 'AD', 'FA', 'EU', '4', 'DL', 'ED', '15', 'ER', 'AP', 'DS', 'BQ', 'AF', 'DS', 'BQ', 'AF', '2', 'EQ', 'DP', 'AP', 'BM', 'AF', 'BM', 'AF']",['93']
871,9,503,593,90,0,12,"['EY', '1', 'AA', 'AF', 'EQ', 'AP', 'BR', 'AF', 'BM', '7', '1', 'AD']",['439']
872,15,503,860,357,0,34,"['EY', '1', 'AA', '7', 'EQ', 'AP', 'BR', 'AF', 'BM', 'AF', '1', 'AD', 'FA', 'EU', '4', 'DL', 'ED', '15', 'ER', 'AP', 'DS', 'BQ', 'AF', 'DS', 'BQ', 'AF', '2', 'EQ', 'DP', 'AP', 'BM', 'AF', 'BM', 'AF']",['606']
873,8,503,588,85,0,30,"['EY', '1', 'AA', '7', 'EQ', 'AP', '1', 'AD', 'FA', 'EU', '4', 'DL', 'ED', '15', 'ER', 'AP', 'DS', 'BQ', 'AF', 'DS', 'BQ', 'AF', '2', 'EQ', 'DP', 'AP', 'BM', 'AF', 'BM', 'AF']",['627']
874,12,503,650,147,0,34,"['EY', '1', 'AA', '7', 'EQ', 'AP', 'BR', 'AF', 'BM', 'AF', '1', 'AD', 'FA', 'EU', '4', 'DL', 'ED', '15', 'ER', 'AP', 'DS', 'BQ', 'AF', 'DS', 'BQ', 'AF', '2', 'EQ', 'DP', 'AP', 'BM', 'AF', 'BM', 'AF']",['784']
875,15,503,541,38,0,34,"['EY', '1', 'AA', '7', 'EQ', 'AP', 'BR', 'AF', 'BM', 'AF', '1', 'AD', 'FA', 'EU', '4', 'DL', 'ED', '15', 'ER', 'AP', 'DS', 'BQ', 'AF', 'DS', 'BQ', 'AF', '2', 'EQ', 'DP', 'AP', 'BM', 'AF', 'BM', 'AF']",['782']
876,8,504,518,14,0,34,"['EY', '1', 'AA', '7', 'EQ', 'AP', 'BR', 'AF', 'BM', 'AF', '1', 'AD', 'FA', 'EU', '4', 'DL', 'ED', '15', 'ER', 'AP', 'DS', 'BQ', 'AF', 'DS', 'BQ', 'AF', '2', 'EQ', 'DP', 'AP', 'BM', 'AF', 'BM', 'AF']",['443']
877,8,504,742,238,0,34,"['EY', '1', 'AA', 'AF', '1', 'AD', 'BR', 'AF', 'BM', '7', 'EQ', 'AP', 'FA', 'EU', '4', 'DL', 'ED', '15', 'ER', 'AP', 'DS', 'BQ', 'AF', 'DS', 'BQ', 'AF', '2', 'EQ', 'DP', 'AP', 'BM', 'AF', 'BM', 'AF']",['490']
878,8,504,606,102,0,34,"['EY', '1', 'AA', '7', 'EQ', 'AP', 'BR', 'AF', 'BM', 'AF', '1', 'AD', 'FA', 'EU', '4', 'DL', 'ED', '15', 'ER', 'AP', 'DS', 'BQ', 'AF', 'DS', 'BQ', 'AF', '2', 'EQ', 'DP', 'AP', 'BM', 'AF', 'BM', 'AF']",['608']
879,8,504,547,43,0,34,"['EY', '1', 'AA', '7', 'EQ', 'AP', 'BR', 'AF', 'BM', 'AF', '1', 'AD', 'FA', 'EU', '4', 'DL', 'ED', '15', 'ER', 'AP', 'DS', 'BQ', 'AF', 'DS', 'BQ', 'AF', '2', 'EQ', 'DP', 'AP', 'BM', 'AF', 'BM', 'AF']",['792']
880,8,504,533,29,0,34,"['EY', '1', 'AA', '7', 'EQ', 'AP', 'BR', 'AF', 'BM', 'AF', '1', 'AD', 'FA', 'EU', '4', 'DL', 'ED', '15', 'ER', 'AP', 'DS', 'BQ', 'AF', 'DS', 'BQ', 'AF', '2', 'EQ', 'DP', 'AP', 'BM', 'AF', 'BM', 'AF']",['788']
881,10,505,634,129,73,35,"['EY', '1', 'AA', 'AF', '1', 'AD', 'BR', 'AF', 'BM', '41', '7', 'EQ', 'AP', 'FA', 'EU', '4', 'DL', 'ED', '15', 'ER', 'AP', 'DS', 'BQ', 'AF', 'DS', 'BQ', 'AF', '2', 'EQ', 'DP', 'AP', 'BM', 'AF', 'BM', 'AF']","['301', '374']"
882,10,505,668,163,0,34,"['EY', '1', 'AA', '7', 'EQ', 'AP', 'BR', 'AF', 'BM', 'AF', '1', 'AD', 'FA', 'EU', '4', 'ED', '15', 'ER', 'AP', 'DS', 'BQ', 'AF', 'DF', 'DS', 'BQ', 'AF', '2', 'EQ', 'DP', 'AP', 'BM', 'AF', 'BM', 'AF']",['609']
883,15,506,549,43,0,34,"['EY', '1', 'AA', '7', 'EQ', 'AP', 'BR', 'AF', 'BM', 'AF', '1', 'AD', 'FA', 'EU', '4', 'DL', 'ED', '15', 'ER', 'AP', 'DS', 'BQ', 'AF', 'DS', 'BQ', 'AF', '2', 'EQ', 'DP', 'AP', 'BM', 'AF', 'BM', 'AF']",['296']
884,15,506,606,100,0,34,"['EY', '1', 'AA', '7', 'EQ', 'AP', 'BR', 'AF', 'BM', 'AF', '1', 'AD', 'FA', 'EU', '4', 'DL', 'ED', '15', 'ER', 'AP', 'DS', 'BQ', 'AF', 'DS', 'BQ', 'AF', '2', 'EQ', 'DP', 'AP', 'BM', 'AF', 'BM', 'AF']",['448']
885,12,506,529,23,0,22,"['EY', 'EU', '4', 'DL', 'ED', '15', 'ER', 'AP', 'DS', 'BQ', 'AF', 'DS', 'BQ', 'AF', '2', 'EQ', 'DP', 'AP', 'BM', 'AF', 'BM', 'AF']",['508']
886,10,506,520,14,0,36,"['EY', '1', 'AA', '7', 'EQ', 'AP', 'BR', 'AF', 'BM', 'AF', '1', 'AD', 'FA', 'EU', '4', 'DL', 'AF', '2', 'ED', '15', 'ER', 'AP', 'DS', 'BQ', 'AF', 'DS', 'BQ', 'AF', '2', 'EQ', 'DP', 'AP', 'BM', 'AF', 'BM', 'AF']",['791']
887,15,506,558,52,0,32,"['EY', '1', 'AA', '7', 'EQ', 'AP', 'BM', 'AF', '1', 'AD', 'FA', 'EU', '4', 'DL', 'ED', '15', 'ER', 'AP', 'DS', 'BQ', 'AF', 'DS', 'BQ', 'AF', '2', 'EQ', 'DP', 'AP', 'BM', 'AF', 'BM', 'AF']",['795']
888,8,507,546,39,0,35,"['EY', '1', 'AA', '7', 'EQ', 'AP', 'BR', 'AF', 'BM', 'AF', '1', 'AD', 'FA', 'EU', '4', 'DL', 'ED', '15', 'ER', 'AP', 'DS', 'BQ', 'AF', 'DS', 'BQ', 'AF', '2', 'EQ', 'DP', 'AP', 'BM', 'AF', 'BM', 'AF', 'FB']",['203']
889,8,507,663,156,0,34,"['EY', '1', 'AA', '7', 'EQ', 'AP', 'BR', 'AF', 'BM', 'AF', '1', 'AD', 'FA', 'EU', '4', 'DL', 'ED', '15', 'ER', 'AP', 'DS', 'BQ', 'AF', 'DS', 'BQ', 'AF', '2', 'EQ', 'DP', 'AP', 'BM', 'AF', 'BM', 'AF']",['307']
890,8,507,550,43,0,34,"['EY', '1', 'AA', '7', 'EQ', 'AP', 'BR', 'AF', 'BM', 'AF', '1', 'AD', 'FA', 'EU', '4', 'DL', 'ED', '15', 'ER', 'AP', 'DS', 'BQ', 'AF', 'DS', 'BQ', 'AF', '2', 'EQ', 'DP', 'AP', 'BM', 'AF', 'BM', 'AF']",['306']
891,8,507,575,68,0,34,"['EY', '1', 'AA', '7', 'EQ', 'AP', 'BR', 'AF', 'BM', 'AF', '1', 'AD', 'FA', 'EU', '4', 'DL', 'ED', '15', 'ER', 'AP', 'DS', 'BQ', 'AF', 'DS', 'BQ', 'AF', '2', 'EQ', 'DP', 'AP', 'BM', 'AF', 'BM', 'AF']",['452']
892,8,507,619,112,0,34,"['EY', '1', 'AA', '7', 'EQ', 'AP', 'BR', 'AF', 'BM', 'AF', '1', 'AD', 'FA', 'EU', '4', 'DL', 'ED', '15', 'ER', 'AP', 'DS', 'BQ', 'AF', 'DS', 'BQ', 'AF', '2', 'EQ', 'DP', 'AP', 'BM', 'AF', 'BM', 'AF']",['449']
893,8,507,562,55,0,34,"['EY', '1', 'AA', '7', 'EQ', 'AP', 'BR', 'AF', 'BM', 'AF', '1', 'AD', 'FA', 'EU', '4', 'DL', 'ED', '15', 'ER', 'AP', 'DS', 'BQ', 'AF', 'DS', 'BQ', 'AF', '2', 'EQ', 'DP', 'AP', 'BM', 'AF', 'BM', 'AF']",['626']
894,8,507,682,175,0,34,"['EY', '1', 'AA', '7', 'EQ', 'AP', 'BR', 'AF', 'BM', 'AF', '1', 'AD', 'FA', 'EU', '4', 'DL', 'ED', '15', 'ER', 'AP', 'DS', 'BQ', 'AF', 'DS', 'BQ', 'AF', '2', 'EQ', 'DP', 'AP', 'BM', 'AF', 'BM', 'AF']",['624']
895,8,507,839,332,0,34,"['EY', '1', 'AA', '7', 'EQ', 'AP', 'EP', 'EI', 'BM', 'AF', '1', 'AD', 'FA', 'EU', '4', 'DL', 'ED', '15', 'ER', 'AP', 'DS', 'BQ', 'AF', 'DS', 'BQ', 'AF', '2', 'EQ', 'DP', 'AP', 'BM', 'AF', 'BM', 'AF']",['622']
896,8,507,580,73,0,34,"['EY', '1', 'AA', '7', 'EQ', 'AP', 'BR', 'AF', 'BM', 'AF', '1', 'AD', 'FA', 'EU', '4', 'DL', 'ED', '15', 'ER', 'AP', 'DS', 'BQ', 'AF', 'DS', 'BQ', 'AF', '2', 'EQ', 'DP', 'AP', 'BM', 'AF', 'BM', 'AF']",['619']
897,8,507,550,43,0,36,"['EY', '1', 'AA', '7', 'EQ', 'AP', 'BR', '1', 'AD', 'AF', 'BM', 'AF', '1', 'AD', 'FA', 'EU', '4', 'DL', 'ED', '15', 'ER', 'AP', 'DS', 'BQ', 'AF', 'DS', 'BQ', 'AF', '2', 'EQ', 'DP', 'AP', 'BM', 'AF', 'BM', 'AF']",['811']
898,8,507,567,60,0,34,"['EY', '1', 'AA', '7', 'EQ', 'AP', 'BR', 'AF', 'BM', 'AF', '1', 'AD', 'FA', 'EU', '4', 'DL', 'ED', '15', 'ER', 'AP', 'DS', 'BQ', 'AF', 'DS', 'BQ', 'AF', '2', 'EQ', 'DP', 'AP', 'BM', 'AF', 'BM', 'AF']",['809']
899,8,507,521,14,0,34,"['EY', '1', 'AA', '7', 'EQ', 'AP', 'BR', 'AF', 'BM', 'AF', '1', 'AD', 'FA', 'EU', '4', 'DL', 'ED', '15', 'ER', 'AP', 'DS', 'BQ', 'AF', 'DS', 'BQ', 'AF', '2', 'EQ', 'DP', 'AP', 'BM', 'AF', 'BM', 'AF']",['805']
900,8,507,582,75,0,34,"['EY', '1', 'AA', '7', 'EQ', 'AP', 'BR', 'AF', 'BM', 'AF', '1', 'AD', 'FA', 'EU', '4', 'DL', 'ED', '15', 'ER', 'AP', 'DS', 'BQ', 'AF', 'DS', 'BQ', 'AF', '2', 'EQ', 'DP', 'AP', 'BM', 'AF', 'BM', 'AF']",['804']
901,8,507,656,149,0,34,"['EY', '1', 'AA', '7', 'EQ', 'AP', 'BR', 'AF', 'BM', 'AF', '1', 'AD', 'FA', 'EU', '4', 'DL', 'ED', '15', 'ER', 'AP', 'DS', 'BQ', 'AF', 'DS', 'BQ', 'AF', '2', 'EQ', 'DP', 'AP', 'BM', 'AF', 'BM', 'AF']",['803']
902,8,507,550,43,0,34,"['EY', '1', 'AA', '7', 'EQ', 'AP', 'BR', 'AF', 'BM', 'AF', '1', 'AD', 'FA', 'EU', '4', 'DL', 'ED', '15', 'ER', 'AP', 'DS', 'BQ', 'AF', 'DS', 'BQ', 'AF', '2', 'EQ', 'DP', 'AP', 'BM', 'AF', 'BM', 'AF']",['801']
903,8,507,573,66,0,34,"['EY', '1', 'AA', '7', 'EQ', 'AP', 'BR', 'AF', 'BM', 'AF', '1', 'AD', 'FA', 'EU', '4', 'DL', 'ED', '15', 'ER', 'AP', 'DS', 'BQ', 'AF', 'DS', 'BQ', 'AF', '2', 'EQ', 'DP', 'AP', 'BM', 'DK', 'BT', 'AF']",['799']
904,6,508,666,158,0,32,"['EY', '1', 'AA', '7', 'EQ', 'AP', 'BR', 'AF', 'BM', 'AF', '1', 'AD', 'FA', 'EU', '4', 'DL', 'ED', '15', 'ER', 'AP', 'DS', 'BQ', 'AF', 'DS', 'BQ', 'AF', '2', 'EQ', 'DP', 'AP', 'BM', 'AF']",['635']
905,13,508,511,3,0,33,"['EY', '1', 'AA', '7', 'EQ', 'BR', 'AF', 'BM', 'AF', '1', 'AD', 'FA', 'EU', '4', 'DL', 'ED', '15', 'ER', 'AP', 'DS', 'BQ', 'AF', 'DS', 'BQ', 'AF', '2', 'EQ', 'DP', 'AP', 'BM', 'AF', 'BM', 'AF']",['815']
906,6,508,520,12,0,32,"['EY', '1', 'AA', '7', 'EQ', 'AP', 'BR', 'AF', 'BM', 'AF', '1', 'AD', 'FA', 'EU', '4', 'DL', 'ED', '15', 'ER', 'AP', 'DS', 'BQ', 'AF', 'DS', 'BQ', 'AF', '2', 'EQ', 'DP', 'AP', 'BM', 'AF']",['813']
907,13,508,511,3,195,34,"['EY', '1', 'AA', '7', 'EQ', 'AP', 'BR', 'AF', 'BM', 'AF', '1', 'AD', 'FA', 'EU', '4', 'DL', 'ED', '15', 'ER', 'AP', 'DS', 'BQ', 'AF', 'DS', 'BQ', 'AF', '2', 'EQ', 'DP', 'AP', 'BM', 'AF', 'BM', 'AF']","['628', '823']"
908,9,509,513,4,0,33,"['EY', '-8', '-81', 'FA', 'AA', 'BR', 'AF', 'BM', 'AF', '1', 'AD', 'FB', 'EU', '4', 'DL', 'ED', '15', 'ER', 'AP', 'DS', 'BQ', 'AF', 'DS', 'BQ', 'AF', '2', 'EQ', 'DP', 'AP', 'BM', 'AF', 'BM', 'AF']",['243']
909,6,509,554,45,214,34,"['EY', '1', 'AA', '7', 'EQ', 'AP', 'BR', 'AF', 'BM', 'AF', 'AF', 'DS', 'FA', 'EU', '4', 'DL', 'ED', '15', 'ER', 'AP', 'DS', 'BQ', '1', 'AD', 'BQ', 'AF', '2', 'EQ', 'DP', 'AP', 'BM', 'AF', 'BM', 'AF']","['472', '258']"
910,6,509,541,32,0,45,"['EY', '1', 'AA', '7', 'EQ', 'AP', 'BR', 'AF', 'BM', 'AF', '1', 'AD', 'FA', 'AA', '7', 'EQ', 'AP', 'BR', 'AF', 'BM', 'AF', '1', 'AD', 'FB', 'EU', '4', 'DL', 'ED', '15', 'ER', 'AP', 'DS', 'BQ', 'AF', 'DS', 'BQ', 'AF', '2', 'EQ', 'DP', 'AP', 'BM', 'AF', 'BM', 'AF']",['634']
911,6,509,576,67,0,31,"['EY', '1', 'AA', '7', 'EQ', 'AP', 'BR', 'AF', 'BM', 'AF', '1', 'AD', 'FA', 'EU', '4', 'DL', 'ED', '15', 'ER', 'AP', 'DS', 'BQ', 'AF', 'DS', 'BQ', 'DP', 'AP', 'BM', 'AF', 'BM', 'AF']",['653']
912,6,509,545,36,176,34,"['EY', '1', 'AA', '7', 'EQ', 'AP', 'BR', 'AF', 'BM', 'AF', '1', 'AD', 'FA', 'EU', '4', 'DL', 'ED', '15', 'ER', 'AP', 'DS', 'BQ', 'AF', 'DS', 'BQ', 'AF', '2', 'EQ', 'DP', 'AP', 'BM', 'AF', 'BM', 'AF']","['473', '649']"
913,6,509,511,2,0,32,"['EY', '1', 'AA', '7', 'EQ', 'BR', 'AF', 'AP', 'BR', 'AF', 'BM', 'AF', '1', 'AD', 'FA', 'EU', '4', 'DL', 'ED', '15', 'ER', 'AP', 'DS', 'BQ', 'AF', 'DS', 'BQ', 'AF', 'BM', 'AF', 'BM', 'AF']",['819']
914,6,509,579,70,0,34,"['EY', '1', 'AA', '7', 'EQ', 'AP', 'BR', 'AF', 'BM', 'AF', '1', 'AD', 'FA', 'EU', '4', 'DL', 'ED', '15', 'ER', 'AP', 'DS', 'BQ', 'AF', 'DS', 'BQ', 'AF', '2', 'EQ', 'DP', 'AP', 'BM', 'AF', 'BM', 'AF']",['817']
915,6,509,566,57,88,34,"['EY', '1', 'AA', '7', 'EQ', 'AP', 'BR', 'AF', 'BM', 'AF', '1', 'AD', 'FA', 'EU', '4', 'DL', 'ED', '15', 'ER', 'AP', 'DS', 'BQ', 'AF', 'DS', 'BQ', 'AF', '2', 'EQ', 'DP', 'AP', 'BM', 'AF', 'BM', 'AF']","['837', '749']"
916,6,509,544,35,3,34,"['EY', '1', 'AA', '7', 'EQ', 'AP', 'BR', 'AF', 'BM', 'AF', '1', 'AD', 'FA', 'EU', '4', 'DL', 'ED', '15', 'ER', 'AP', 'DS', 'BQ', 'AF', 'DS', 'BQ', 'AF', '2', 'EQ', 'DP', 'AP', 'BM', 'AF', 'BM', 'AF']","['832', '835']"
917,13,511,584,73,0,34,"['EY', '1', 'AA', '7', 'EQ', 'AP', 'BR', 'AF', 'BM', 'AF', '1', 'AD', 'FA', 'EU', '4', 'DL', 'ED', '15', 'ER', 'AP', 'DS', 'BQ', 'AF', 'DS', 'BQ', 'AF', '2', 'EQ', 'DP', 'AP', 'BM', 'AF', 'BM', 'AF']",['468']
918,13,511,517,6,0,34,"['EY', '1', 'AA', '7', 'EQ', 'AP', 'BR', 'AF', 'BM', 'AF', '1', 'AD', 'FA', 'EU', '4', 'DL', 'ED', '15', 'ER', 'AP', 'DS', 'BQ', 'AF', 'DS', 'BQ', 'AF', '2', 'EQ', 'DP', 'AP', 'BM', 'AF', 'BM', 'AF']",['465']
919,13,511,568,57,0,34,"['EY', '1', 'AA', '7', 'EQ', 'AP', 'BR', 'AF', 'BM', 'AF', '1', 'AD', 'FA', 'EU', '4', 'DL', 'ED', '15', 'ER', 'AP', 'DS', 'BQ', 'AF', 'DS', 'BQ', 'AF', '2', 'EQ', 'DP', 'AP', 'BM', 'AF', 'BM', 'AF']",['464']
920,13,511,518,7,0,34,"['EY', '1', 'AA', '7', 'EQ', 'AP', 'BR', 'AF', 'BM', 'AF', '1', 'AD', 'FA', 'EU', '4', 'DL', 'ED', '15', 'ER', 'AP', 'DS', 'BQ', 'AF', 'DS', 'BQ', 'AF', '2', 'EQ', 'DP', 'AP', 'BM', 'AF', 'BM', 'AF']",['463']
921,13,511,516,5,0,34,"['EY', '1', 'AA', '7', 'EQ', 'AP', 'BR', 'AF', 'BM', 'AF', '1', 'AD', 'FA', 'EU', '4', 'DL', 'ED', '15', 'ER', 'AP', 'DS', 'BQ', 'AF', 'DS', 'BQ', 'AF', '2', 'EQ', 'DP', 'AP', 'BM', 'AF', 'BM', 'AF']",['644']
922,13,511,531,20,0,34,"['EY', '1', 'AA', '7', 'EQ', 'AP', 'BR', 'AF', 'BM', 'AF', '1', 'AD', 'FA', 'EU', '4', 'DL', 'ED', '15', 'ER', 'AP', 'DS', 'BQ', 'AF', 'DS', 'BQ', 'AF', '2', 'EQ', 'DP', 'AP', 'BM', 'AF', 'BM', 'AF']",['637']
923,13,511,525,14,0,35,"['EY', '1', 'AA', '7', 'EQ', 'AP', 'BR', 'AF', 'BM', 'AF', '1', 'AD', 'FA', 'EU', '4', 'DL', 'ED', '15', 'ER', 'AP', 'DS', 'BQ', 'AF', 'DS', 'BQ', 'AF', '2', 'EQ', 'DP', 'AP', 'BM', 'AF', 'BM', 'AF', 'FB']",['833']
924,13,511,565,54,0,34,"['EY', '1', 'AA', '7', 'EQ', 'AP', 'BR', 'AP', 'BM', 'AF', '1', 'AD', 'FA', 'EU', '4', 'DL', 'ED', '15', 'ER', 'AP', 'DS', 'BQ', 'AF', 'DS', 'BQ', 'AF', '2', 'EQ', 'DP', 'AF', 'BM', 'AF', 'BM', 'AF']",['830']
925,13,511,559,48,0,34,"['EY', '-1', 'AA', '9', 'EQ', 'AP', 'BR', 'AF', 'BM', 'AF', '5', 'AD', 'FA', 'EU', '4', 'DL', 'ED', '15', 'ER', 'AP', 'DS', 'BQ', 'AF', 'DS', 'BQ', 'AF', '2', 'EQ', 'DP', 'AP', 'BM', 'AF', 'BM', 'AF']",['828']
926,13,511,525,14,0,34,"['EY', '1', 'AA', '7', 'EQ', 'AP', 'BR', 'AF', 'BM', 'AF', '1', 'AD', 'FA', 'EU', '4', 'DL', 'ED', '15', 'ER', 'AP', 'DS', 'BQ', 'AF', 'DS', 'BQ', 'AF', '2', 'EQ', 'DP', 'AP', 'BM', 'AF', 'BM', 'AF']",['827']
927,13,511,514,3,0,35,"['EY', 'AM', 'FA', 'AA', '7', 'EQ', 'AP', 'BR', 'AF', 'BM', 'AF', '1', 'AD', 'FB', 'EU', '4', 'DL', 'ED', '15', 'ER', 'AP', 'DS', 'BQ', 'AF', 'DS', 'BQ', 'AF', '2', 'EQ', 'DP', 'AP', 'BM', 'AF', 'BM', 'AF']",['824']
928,13,511,520,9,0,37,"['EY', '1', 'AA', '7', 'EQ', 'AP', 'BR', 'AF', 'BM', 'AF', '1', 'AD', 'AF', 'BM', 'AF', 'FA', 'EU', '4', 'DL', 'ED', '15', 'ER', 'AP', 'DS', 'BQ', 'AF', 'DS', 'BQ', 'AF', '2', 'EQ', 'DP', 'AP', 'BM', 'AF', 'BM', 'AF']",['822']
929,13,511,525,14,0,34,"['EY', '1', 'AA', '7', 'EQ', 'AP', 'BR', 'AF', 'BM', 'AF', '1', 'AD', 'FA', 'EU', '4', 'DL', 'ED', '15', 'ER', 'AP', 'DS', 'BQ', 'AF', 'DS', 'BQ', 'AF', '2', 'EQ', 'DP', 'AP', 'BM', 'AF', 'BM', 'AF']",['821']
930,6,512,682,170,0,34,"['EY', '1', 'AA', '7', 'EQ', 'AP', 'BR', 'AF', 'BM', 'AF', '1', 'AD', 'FA', 'EU', '4', 'DL', 'ED', '15', 'ER', 'AP', 'DS', 'BQ', 'AF', 'DS', 'BQ', 'AF', '2', 'EQ', 'DP', 'AP', 'BM', 'AF', 'BM', 'AF']",['213']
931,6,512,555,43,0,34,"['EY', '1', 'AA', '7', 'EQ', 'AP', 'BR', 'AF', 'BM', 'AF', '1', 'AD', 'FA', 'EU', '4', 'DL', 'ED', '15', 'ER', 'AP', 'DS', 'BQ', 'AF', 'DS', 'BQ', 'AF', '2', 'EQ', 'DP', 'AP', 'BM', 'AF', 'BM', 'AF']",['334']
932,6,512,696,184,0,34,"['EY', '1', 'AA', '7', 'EQ', 'AP', 'BR', 'AF', 'BM', 'AF', '1', 'AD', 'FA', 'EU', '4', 'DL', 'ED', '15', 'ER', 'AP', 'DS', 'BQ', 'AF', 'DS', 'BQ', 'AF', '2', 'EQ', 'DP', 'AP', 'BM', 'AF', 'BM', 'AF']",['475']
933,6,512,518,6,0,38,"['EY', '1', 'AA', '7', 'EQ', 'AP', 'BR', 'AF', 'BM', 'AF', '1', 'AD', 'BM', 'AF', '1', 'AD', 'FA', 'EU', '4', 'DL', 'ED', '15', 'ER', 'AP', 'DS', 'BQ', 'AF', 'DS', 'BQ', 'AF', '2', 'EQ', 'DP', 'AP', 'BM', 'AF', 'BM', 'AF']",['471']
934,6,512,612,100,0,34,"['EY', '1', 'AA', '7', 'EQ', 'AP', 'BR', 'AF', 'BM', 'AF', '1', 'AD', 'FA', 'EU', '4', 'DL', 'ED', '15', 'ER', 'AP', 'DS', 'BQ', 'AF', 'DS', 'BQ', 'AF', '2', 'EQ', 'DP', 'AP', 'BM', 'AF', 'BM', 'AF']",['656']
935,6,512,526,14,0,34,"['EY', '1', 'AA', '7', 'EQ', 'AP', 'BR', 'AF', 'BM', 'AF', '1', 'AD', 'FA', 'EU', '4', 'DL', 'ED', '15', 'ER', 'AP', 'DS', 'BQ', 'AF', 'DS', 'BQ', 'AF', '2', 'EQ', 'DP', 'AP', 'BM', 'AF', 'BM', 'AF']",['650']
936,6,512,558,46,0,34,"['EY', '1', 'AA', '7', 'EQ', 'AP', 'BR', 'AF', 'BM', 'AF', '1', 'AD', 'FA', 'EU', '4', 'DL', 'ED', '15', 'ER', 'AP', 'DS', 'BQ', 'AF', 'DS', 'BQ', 'AF', '2', 'EQ', 'DP', 'AP', 'BM', 'AF', 'BM', 'AF']",['836']
937,11,513,527,14,0,34,"['EY', '1', 'AA', '7', 'EQ', 'AP', 'BR', 'AF', 'BM', 'AF', '1', 'AD', 'FA', 'EU', '4', 'DL', 'ED', '15', 'ER', 'AP', 'DS', 'BQ', 'AF', 'DS', 'BQ', 'AF', '2', 'EQ', 'DP', 'AP', 'BM', 'AF', 'BM', 'AF']",['336']
938,11,513,589,76,0,34,"['EY', '1', 'AA', '7', 'EQ', 'AP', 'BR', 'AF', 'BM', 'AF', '1', 'AD', 'FA', 'EU', '4', 'DL', 'ED', '15', 'ER', 'AP', 'DS', 'BQ', 'AF', 'DS', 'BQ', 'AF', '2', 'EQ', 'DP', 'AP', 'BM', 'AF', 'BM', 'AF']",['657']
939,4,513,559,46,5,37,"['EY', '1', 'AA', '7', 'EQ', 'AP', 'BR', 'AF', 'BM', 'AF', '1', 'AD', 'AF', 'BM', 'AF', 'FA', 'EU', '4', 'DL', 'ED', '15', 'ER', 'AP', 'DS', 'BQ', 'AF', 'DS', 'BQ', 'AF', '2', 'EQ', 'DP', 'AP', 'BM', 'AF', 'BM', 'AF']","['672', '667']"
940,11,513,867,354,0,34,"['EY', '1', 'AA', '7', 'EQ', 'AP', 'BR', 'AF', 'BM', 'AF', '1', 'AD', 'FA', 'EU', '4', 'DL', 'ED', '15', 'ER', 'AP', 'DS', 'BQ', 'AF', 'DS', 'BQ', 'AF', '2', 'EQ', 'DP', 'AP', 'BM', 'DK', 'BT', 'AF']",['841']
941,11,513,541,28,0,37,"['EY', '1', 'AA', '7', 'EQ', 'AP', 'BR', 'AF', 'BM', 'AF', '1', 'AD', 'AF', 'BM', 'AF', 'FA', 'EU', '4', 'DL', 'ED', '15', 'ER', 'AP', 'DS', 'BQ', 'AF', 'DS', 'BQ', 'AF', '2', 'EQ', 'DP', 'AP', 'BM', 'AF', 'BM', 'AF']",['840']
942,11,513,530,17,0,31,"['EY', '1', 'AA', '7', 'EQ', 'AP', 'BR', 'AF', 'BM', 'AF', '1', 'AD', 'FA', 'EU', '4', 'DL', 'ED', 'DS', 'BQ', 'AF', 'DS', 'BQ', 'AF', '2', 'EQ', 'DP', 'AP', 'BM', 'AF', 'BM', 'AF']",['839']
943,11,513,525,12,21,35,"['EY', '1', 'AA', '7', 'ES', 'EQ', 'AP', 'BR', 'AF', 'BM', 'AF', '1', 'AD', 'FA', 'EU', '4', 'DL', 'ED', '15', 'ER', 'AP', 'DS', 'BQ', 'AF', 'DS', 'BQ', 'AF', '2', 'EQ', 'DP', 'AP', 'BM', 'AQ', 'BK', 'AI']","['864', '843']"
944,11,513,517,4,191,34,"['EY', '1', 'AA', '7', 'EQ', 'AP', 'BR', 'AF', 'BM', 'AF', '1', 'AD', 'FA', 'EU', '4', 'DL', 'ED', '15', 'ER', 'AP', 'DS', 'BQ', 'AF', 'DS', 'BQ', 'AF', '2', 'EQ', 'DP', 'AP', 'BM', 'AF', 'BM', 'AF']","['853', '662']"
945,7,514,746,232,-302,34,"['EY', '1', 'AA', 'AF', '1', 'AD', 'BR', 'AF', 'BM', '7', 'EQ', 'AP', 'FA', 'EU', '4', 'DL', 'ED', '15', 'ER', 'AP', 'DS', 'BQ', 'AF', 'DS', 'BQ', 'AF', '2', 'EQ', 'DP', 'AP', 'BM', 'AF', 'BM', 'AF']","['418', '116']"
946,4,514,587,73,-346,34,"['EY', '1', 'AA', '7', 'EQ', 'AP', 'BR', 'AF', 'BM', 'AF', '1', 'AD', 'FA', 'EU', '4', 'DL', 'ED', '15', 'ER', 'AP', 'DS', 'BQ', 'AF', 'DS', 'BQ', 'AF', '2', 'EQ', 'DP', 'AP', 'BM', 'AF', 'BM', 'AF']","['497', '151']"
947,13,514,531,17,0,34,"['EY', '1', 'AA', '7', 'EQ', 'AP', 'BR', 'EE', 'DK', 'DL', '1', 'AD', 'FA', 'EU', '4', 'DL', 'ED', '15', 'ER', 'AP', 'DS', 'BQ', 'AF', 'DS', 'BQ', 'AF', '2', 'EQ', 'DP', 'AP', 'BM', 'AF', 'BM', 'AF']",['844']
948,11,514,537,23,0,33,"['EY', 'EU', '4', 'DL', 'ED', '15', 'ER', 'AP', 'DS', 'BQ', 'AF', 'DS', 'BQ', 'AF', '2', 'EQ', 'DP', 'AP', 'BM', 'AF', 'BM', 'AF', 'FA', 'AA', '7', 'EQ', 'AP', 'BR', 'AF', 'BM', 'AF', '1', 'AD']",['852']
949,9,515,537,22,0,34,"['EY', '1', 'AA', 'AF', '1', 'AD', 'BR', 'AF', 'BM', '7', 'EQ', 'AP', 'FA', 'EU', '4', 'DL', 'ED', '15', 'ER', 'AP', 'DS', 'BQ', 'AF', 'DS', 'BQ', 'AF', '2', 'EQ', 'DP', 'AP', 'BM', 'AF', 'BM', 'AF']",['419']
950,9,515,592,77,129,34,"['EY', '1', 'AA', 'AF', '1', 'AD', 'BR', 'AF', 'BM', '7', 'EQ', 'AP', 'FA', 'EU', '4', 'DL', 'ED', '15', 'ER', 'AP', 'DS', 'BQ', 'AF', 'DS', 'BQ', 'AF', '2', 'EQ', 'DP', 'AP', 'BM', 'AF', 'BM', 'AF']","['313', '442']"
951,18,515,582,67,0,30,"['EY', '1', 'AA', '7', 'EQ', 'AP', 'BR', 'AF', 'BM', 'AF', '1', 'AD', 'FA', 'EU', '4', 'DL', 'ED', '15', 'ER', 'AP', 'DS', 'BQ', 'AF', 'EQ', 'DP', 'AP', 'BM', 'AF', 'BM', 'AF']",['846']
952,11,516,624,108,0,35,"['EY', '1', 'AA', '7', 'EQ', 'AP', 'BR', 'AF', 'BM', 'AF', '1', 'AD', 'FA', 'EU', '4', 'DL', 'ED', '15', 'ER', 'AP', 'DS', 'BQ', 'AF', 'DS', 'BQ', 'AF', '2', 'EQ', 'DP', 'AP', 'BM', 'AF', 'BM', 'AF', 'FB']",['340']
953,11,516,643,127,0,34,"['EY', '1', 'AA', '7', 'EQ', 'AP', 'BR', 'AF', 'BM', 'AF', '1', 'AD', 'FA', 'EU', '4', 'DL', 'ED', '15', 'ER', 'AP', 'DS', 'BQ', 'AF', 'DS', 'BQ', 'AF', '2', 'EQ', 'DP', 'AP', 'BM', 'AF', 'BM', 'AF']",['488']
954,11,516,517,1,0,34,"['EY', '1', 'AA', '7', 'EQ', 'AP', 'BR', 'AF', 'BM', 'AF', '1', 'AD', 'FA', 'EU', '4', 'DL', 'ED', '15', 'ER', 'AP', 'DS', 'BQ', 'AF', 'DS', 'BQ', 'AF', '2', 'EQ', 'DP', 'AP', 'BM', 'AF', 'BM', 'AF']",['664']
955,11,516,721,205,0,34,"['EY', '1', 'AA', '7', 'EQ', 'AP', 'BR', 'AF', 'BM', 'AF', '1', 'AD', 'FA', 'EU', '4', 'DL', 'ED', '15', 'ER', 'AP', 'DS', 'BQ', 'AF', 'DS', 'BQ', 'AF', '2', 'EQ', 'DP', 'AP', 'BM', 'AF', 'BM', 'AF']",['661']
956,11,516,530,14,0,34,"['EY', '1', 'AA', '7', 'EQ', 'AP', 'BR', 'AF', 'BM', 'AF', '1', 'AD', 'FA', 'EU', '4', 'DL', 'ED', '15', 'ER', 'AP', 'DS', 'BQ', 'AF', 'DS', 'BQ', 'AF', '2', 'EQ', 'DP', 'AP', 'BM', 'AF', 'BM', 'AF']",['867']
957,11,516,540,24,0,34,"['EY', '1', 'AA', '7', 'EQ', 'AP', 'BR', 'AF', 'BM', 'AF', '1', 'AD', 'FA', 'EU', '4', 'DL', 'ED', '15', 'ER', 'AP', 'DS', 'BQ', 'AF', 'DS', 'BQ', 'AF', '2', 'EQ', 'DP', 'AP', 'BM', 'AF', 'BM', 'AF']",['866']
958,11,516,586,70,0,34,"['EY', '1', 'AA', '7', 'EQ', 'AP', 'BR', 'AF', 'BM', 'AF', '1', 'AD', 'FA', 'EU', '4', 'DL', 'ED', '15', 'ER', 'AP', 'DS', 'BQ', 'AF', 'DS', 'BQ', 'AF', '2', 'EQ', 'DP', 'AP', 'BM', 'DK', 'BT', 'AF']",['858']
959,11,516,568,52,0,34,"['EY', '1', 'AA', '7', 'EQ', 'AP', 'BR', 'AF', 'BM', 'AF', '1', 'AD', 'FA', 'EU', '4', 'DL', 'ED', '15', 'ER', 'AP', 'DS', 'BQ', 'AF', 'DS', 'BQ', 'AF', '2', 'EQ', 'DP', 'AP', 'BM', 'AF', 'BM', 'AF']",['857']
960,11,516,559,43,0,34,"['EY', '1', 'AA', '7', 'EQ', 'AP', 'BR', 'AF', 'BM', 'AF', '1', 'AD', 'FA', 'EU', '4', 'DL', 'ED', '15', 'ER', 'AP', 'DS', 'BQ', 'AF', 'DS', 'BQ', 'AF', '2', 'EQ', 'DP', 'AP', 'BM', 'AF', 'BM', 'AF']",['856']
961,11,516,530,14,0,35,"['EY', '1', 'AA', '7', 'EQ', 'AP', 'BR', 'AF', 'BM', 'AF', '1', 'AD', 'FA', 'EU', '4', 'DL', 'ED', '15', 'ER', 'AP', 'DS', 'BQ', 'AF', 'DS', 'BQ', 'AF', '2', 'EQ', 'DP', 'AP', 'BM', 'AF', 'BM', 'AF', 'FB']",['855']
962,11,516,530,14,0,34,"['EY', '1', 'AA', '7', 'EQ', 'AP', 'BR', 'AF', 'BM', 'AF', '1', 'AD', 'FA', 'EU', '4', 'DL', 'ED', '15', 'ER', 'AP', 'DS', 'BQ', 'AF', 'DS', 'BQ', 'AF', '2', 'EQ', 'DP', 'AP', 'BM', 'AF', 'BM', 'AF']",['854']
963,11,516,530,14,0,34,"['EY', '1', 'AA', '7', 'EQ', 'AP', 'BR', 'AF', 'BM', 'AF', '1', 'AD', 'FA', 'EU', '4', 'DL', 'ED', '15', 'ER', 'AP', 'DS', 'BQ', 'AF', 'DS', 'BQ', 'AF', '2', 'EQ', 'DP', 'AP', 'BM', 'AF', 'BM', 'AF']",['851']
964,11,516,564,48,0,32,"['EY', '1', 'AA', 'AP', 'BR', 'AF', 'BM', 'AF', '1', 'AD', 'FA', 'EU', '4', 'DL', 'ED', '15', 'ER', 'AP', 'DS', 'BQ', 'AF', 'DS', 'BQ', 'AF', '2', 'EQ', 'DP', 'AP', 'BM', 'AF', 'BM', 'AF']",['850']
965,7,517,559,42,0,34,"['EY', '1', 'AA', 'AF', '1', 'AD', 'BR', 'AF', 'BM', '7', 'EQ', 'AP', 'FA', 'EU', '4', 'DL', 'ED', '15', 'ER', 'AP', 'DS', 'BQ', 'AF', 'DS', 'BQ', 'AF', '2', 'EQ', 'DP', 'AP', 'BM', 'AF', 'BM', 'AF']",['312']
966,13,517,626,109,-552,34,"['EY', '1', 'AA', '7', 'EQ', 'AP', 'BR', 'AF', 'BM', 'AF', '1', 'AD', 'FA', 'EU', '4', 'DL', 'ED', '15', 'ER', 'AP', 'DS', 'BQ', 'AF', 'DS', 'BQ', 'AF', '2', 'EQ', 'DP', 'AP', 'BM', 'AF', 'BM', 'AF']","['874', '322']"
967,16,517,742,225,0,34,"['EY', '1', 'AA', '7', 'EQ', 'AP', 'BR', 'AF', 'BM', 'AF', '1', 'AD', 'FA', 'EU', '4', 'DL', 'ED', '15', 'ER', 'AP', 'DS', 'BQ', 'AF', 'DS', 'BQ', 'AF', '2', 'EQ', 'DP', 'AP', 'BM', 'AF', 'BM', 'AF']",['506']
968,4,517,791,274,0,34,"['EY', '1', 'AA', '7', 'EQ', 'AP', 'BR', 'AF', 'BM', 'AF', '1', 'AD', 'FA', 'EU', '4', 'DL', 'ED', '15', 'ER', 'AP', 'DS', 'BQ', 'AF', 'DS', 'BQ', 'AF', '2', 'EQ', 'DP', 'AP', 'BM', 'AF', 'BM', 'AF']",['502']
969,4,517,540,23,0,33,"['EY', 'EU', '4', 'DL', 'ED', '15', 'ER', 'AP', 'DS', 'BQ', 'AF', 'DS', 'BQ', 'AF', '2', 'EQ', 'DP', 'AP', 'BM', 'AF', 'BM', 'AF', 'FA', 'AA', '7', 'EQ', 'AP', 'BR', 'AF', 'BM', 'AF', '1', 'AD']",['499']
970,16,517,560,43,0,34,"['EY', '1', 'AA', '7', 'EQ', 'AP', 'BR', 'AF', 'BM', 'AF', '1', 'AD', 'FA', 'EU', '4', 'DL', 'ED', '15', 'ER', 'AP', 'DS', 'BQ', 'AF', 'DS', 'BQ', 'AF', '2', 'EQ', 'DP', 'AP', 'BM', 'AF', 'BM', 'AF']",['676']
971,9,517,555,38,0,30,"['EY', '1', 'AA', '7', 'EQ', 'AP', '1', 'AD', 'FA', 'EU', '4', 'DL', 'ED', '15', 'ER', 'AP', 'DS', 'BQ', 'AF', 'DS', 'BQ', 'AF', '2', 'EQ', 'DP', 'AP', 'BM', 'AF', 'BM', 'AF']",['873']
972,16,517,548,31,0,34,"['EY', '1', 'AA', '7', 'EQ', 'AP', 'BR', 'AF', 'BM', 'AF', '1', 'AD', 'FA', 'EU', '4', 'DL', 'ED', '15', 'ER', 'AP', 'DS', 'BQ', 'AF', 'DS', 'BQ', 'AF', '2', 'EQ', 'DP', 'AP', 'BM', 'AF', 'BM', 'AF']",['872']
973,4,517,579,62,0,35,"['EY', '1', 'AA', '7', 'EQ', 'AP', 'BR', 'AF', 'BM', 'BM', 'AF', '1', 'AD', 'FA', 'EU', '4', 'DL', 'ED', '15', 'ER', 'AP', 'DS', 'BQ', 'AF', 'DS', 'BQ', 'AF', '2', 'EQ', 'DP', 'AP', 'BM', 'AF', 'BM', 'AF']",['870']
974,9,518,630,112,0,34,"['EY', '1', 'AA', '7', 'EQ', 'AP', 'BR', 'AF', 'BM', 'AF', '1', 'AD', 'FA', 'EU', '4', 'DL', 'ED', '15', 'ER', 'AP', 'DS', 'BQ', 'AF', 'DS', 'BQ', 'AF', '2', 'EQ', 'DP', 'AP', 'BM', 'AF', 'BM', 'AF']",['350']
975,9,518,552,34,-357,33,"['EY', '1', 'AA', '7', 'EQ', 'AP', 'BR', 'AF', 'BM', 'AF', 'AD', 'FA', 'EU', '4', 'DL', 'ED', '15', 'ER', 'AP', 'DS', 'BQ', 'AF', 'DS', 'BQ', 'AF', '2', 'EQ', 'DP', 'AP', 'BM', 'AF', 'BM', 'AF']","['521', '878']"
976,9,518,539,21,0,34,"['EY', '1', 'AA', '7', 'EQ', 'AP', 'BR', 'AF', 'BM', 'AF', '1', 'AD', 'FA', 'EU', '4', 'DL', 'ED', '15', 'ER', 'AP', 'DS', 'BQ', 'AF', 'DS', 'BQ', 'AF', '2', 'EQ', 'DP', 'AP', 'BM', 'AF', 'BM', 'AF']",['680']
977,9,518,602,84,0,34,"['EY', '1', 'AA', '7', 'EQ', 'AP', 'BR', 'AF', 'BM', 'AF', '1', 'AD', 'FA', 'EU', '4', 'DL', 'ED', '15', 'ER', 'AP', 'DS', 'BQ', 'AF', 'DS', 'BQ', 'AF', '2', 'EQ', 'DP', 'AP', 'BM', 'AF', 'BM', 'AF']",['879']
978,9,518,521,3,214,34,"['EY', '1', 'AA', '7', 'EQ', 'AP', 'BR', 'AF', 'BM', 'AF', '1', 'AD', 'FA', 'EU', '4', 'DL', 'ED', '15', 'ER', 'AP', 'DS', 'BQ', 'AF', 'DS', 'BQ', 'AF', '2', 'EQ', 'DP', 'AP', 'BM', 'AF', 'BM', 'AF']","['681', '895']"
979,9,518,535,17,-12,34,"['EY', '1', 'AA', '7', 'EQ', 'AP', 'BR', 'AF', 'BM', 'AF', '1', 'AD', 'FA', 'EU', '4', 'DL', 'ED', '15', 'ER', 'AP', 'DS', 'BQ', 'AF', 'DS', 'BQ', 'AF', '2', 'EQ', 'DP', 'AP', 'BM', 'AF', 'BM', 'AF']","['891', '903']"
980,11,519,534,15,18,34,"['EY', '1', 'AA', '7', 'EQ', 'AP', 'BR', 'AF', 'BM', 'AF', '1', 'AD', 'FA', 'EU', '4', 'DL', 'ED', '15', 'ER', 'AP', 'DS', 'BQ', 'AF', 'DS', 'BQ', 'AF', '2', 'EQ', 'DP', 'AP', 'BM', 'AF', 'BM', 'AF']","['704', '686']"
981,11,519,620,101,0,34,"['EY', '1', 'AA', '7', 'EQ', 'AP', 'BR', 'AF', 'BM', 'AF', '1', 'AD', 'FA', 'EU', '4', 'ED', '15', 'ER', 'AP', 'DS', 'BQ', 'AF', 'DF', 'DS', 'BQ', 'AF', '2', 'EQ', 'DP', 'AP', 'BM', 'AF', 'BM', 'AF']",['882']
982,16,520,534,14,0,34,"['EY', '1', 'AA', '7', 'EQ', 'AP', 'BR', 'AF', 'BM', 'AF', '1', 'AD', 'FA', 'EU', '4', 'DL', 'ED', '15', 'ER', 'AP', 'DS', 'BQ', 'AF', 'DS', 'BQ', 'AF', '2', 'EQ', 'DP', 'AP', 'BM', 'AF', 'BM', 'AF']",['512']
983,9,520,553,33,0,33,"['EY', '1', 'AA', '7', 'EQ', 'AP', 'BR', 'AF', 'BM', 'AF', '1', 'AD', 'FA', 'EU', '4', 'DL', 'ED', '15', 'ER', 'AP', 'DS', 'BQ', 'AF', 'DS', 'BQ', '2', 'EQ', 'DP', 'AP', 'BM', 'AF', 'BM', 'AF']",['701']
984,7,520,616,96,0,31,"['EY', '1', 'AA', 'BR', 'AF', 'BM', 'AF', '1', 'AD', 'FA', 'EU', '4', 'DL', 'ED', '15', 'ER', 'AP', 'DS', 'BQ', 'AF', 'DS', 'BQ', 'AF', '2', 'EQ', 'DP', 'AP', 'BM', 'AF', 'BM', 'AF']",['706']
985,7,520,535,15,17,34,"['EY', '1', 'AA', '7', 'EQ', 'AP', 'BR', 'AF', 'BM', 'AF', '1', 'AD', 'FA', 'EU', '4', 'DL', 'ED', '15', 'ER', 'AP', 'DS', 'BQ', 'AF', 'DS', 'BQ', 'AF', '2', 'EQ', 'DP', 'AP', 'BM', 'AF', 'BM', 'AF']","['688', '705']"
986,16,520,617,97,0,32,"['EY', '1', 'AA', '7', 'EQ', 'AP', 'BM', 'AF', '1', 'AD', 'FA', 'EU', '4', 'DL', 'ED', '15', 'ER', 'AP', 'DS', 'BQ', 'AF', 'DS', 'BQ', 'AF', '2', 'EQ', 'DP', 'AP', 'BM', 'AF', 'BM', 'AF']",['887']
987,16,520,553,33,0,34,"['EY', '1', 'AA', '7', 'EQ', 'AP', 'BR', 'AF', 'BM', 'AF', '1', 'AD', 'FA', 'EU', '4', 'DL', 'ED', '15', 'ER', 'AP', 'DS', 'BQ', 'AF', 'DS', 'BQ', 'AF', '2', 'EQ', 'DP', 'AP', 'BM', 'AF', 'BM', 'AF']",['884']
988,16,520,609,89,0,34,"['EY', '1', 'AA', '7', 'EQ', 'AP', 'BR', 'AF', 'BM', 'AF', '1', 'AD', 'FA', 'EU', '4', 'DL', 'ED', '15', 'ER', 'AP', 'DS', 'BQ', 'AF', 'DS', 'BQ', 'AF', '2', 'EQ', 'DP', 'AP', 'BM', 'AF', 'BM', 'AF']",['883']
989,7,520,521,1,14,34,"['EY', '1', 'AA', '7', 'EQ', 'AP', 'BR', 'AF', 'BM', 'AF', '1', 'AD', 'FA', 'EU', '4', 'DL', 'ED', '15', 'ER', 'AP', 'DS', 'BQ', 'AF', 'DS', 'BQ', 'AF', '2', 'EQ', 'DP', 'AP', 'BM', 'AF', 'BM', 'AF']","['915', '901']"
990,9,521,660,139,0,34,"['EY', '1', 'AA', '7', 'EQ', 'AP', 'BR', 'AF', 'BM', 'AF', '1', 'AD', 'FA', 'EU', '4', 'DL', 'ED', '15', 'ER', 'AP', 'DS', 'BQ', 'AF', 'DS', 'BQ', 'AF', '2', 'EQ', 'DP', 'AP', 'BM', 'AF', 'BM', 'AF']",['244']
991,9,521,535,14,0,34,"['EY', '1', 'AA', '7', 'EQ', 'AP', 'BR', 'AF', 'BM', 'AF', '1', 'AD', 'FA', 'EU', '4', 'DL', 'ED', '15', 'ER', 'AP', 'DS', 'BQ', 'AF', 'DS', 'BQ', 'AF', '2', 'EQ', 'DP', 'AP', 'BM', 'AF', 'BM', 'AF']",['368']
992,9,521,525,4,0,36,"['EY', '-74', 'EX', 'FA', 'AA', '7', 'EQ', 'AP', 'BR', 'AF', 'BM', 'AF', '1', 'AD', 'FB', 'EU', '4', 'DL', 'ED', '15', 'ER', 'AP', 'DS', 'BQ', 'AF', 'DS', 'BQ', 'AF', '2', 'EQ', 'DP', 'AP', 'BM', 'AF', 'BM', 'AF']",['366']
993,9,521,634,113,0,34,"['EY', '1', 'AA', '7', 'EQ', 'AP', 'BR', 'AF', 'BM', 'AF', '1', 'AD', 'FA', 'EU', '4', 'DL', 'ED', '15', 'ER', 'AP', 'DS', 'BQ', 'AF', 'DS', 'BQ', 'AF', '2', 'EQ', 'DP', 'AP', 'BM', 'DK', 'BT', 'AF']",['363']
994,9,521,549,28,0,34,"['EY', '1', 'AA', '7', 'EQ', 'AP', 'BR', 'AF', 'BM', 'AF', '1', 'AD', 'FA', 'EU', '4', 'DL', 'ED', '15', 'ER', 'AP', 'DS', 'BQ', 'AF', 'DS', 'BQ', 'AF', '2', 'EQ', 'DP', 'AP', 'BM', 'AF', 'BM', 'AF']",['520']
995,9,521,589,68,0,34,"['EY', '1', 'AA', '7', 'EQ', 'AP', 'BR', 'AF', 'BM', 'AF', '1', 'AD', 'FA', 'EU', '4', 'DL', 'ED', '15', 'ER', 'AP', 'DS', 'BQ', 'AF', 'DS', 'BQ', 'AF', '2', 'EQ', 'DP', 'AP', 'BM', 'AF', 'BM', 'AF']",['518']
996,9,521,549,28,0,34,"['EY', '1', 'AA', '7', 'EQ', 'AP', 'BR', 'AF', 'BM', 'AF', '1', 'AD', 'FA', 'EU', '4', 'DL', 'ED', '15', 'ER', 'AP', 'DS', 'BQ', 'AF', 'DS', 'BQ', 'AF', '2', 'EQ', 'DP', 'AP', 'BM', 'AF', 'BM', 'AF']",['517']
997,9,521,814,293,0,33,"['EY', '1', 'AA', '7', 'EQ', 'AP', 'AF', 'BM', 'AF', '1', 'AD', 'FA', 'EU', '4', 'DL', 'ED', '15', 'ER', 'AP', 'DS', 'BQ', 'AF', 'DS', 'BQ', 'AF', '2', 'EQ', 'DP', 'AP', 'BM', 'AF', 'BM', 'AF']",['515']
998,9,521,754,233,0,34,"['EY', '1', 'AA', '7', 'EQ', 'AP', 'BR', 'AF', 'BM', 'AF', '1', 'AD', 'FA', 'EU', '4', 'DL', 'ED', '15', 'ER', 'AP', 'DS', 'BQ', 'AF', 'DS', 'BQ', 'AF', '2', 'EQ', 'DP', 'AP', 'BM', 'AQ', 'BK', 'AI']",['514']
999,9,521,842,321,0,34,"['EY', '1', 'AA', '7', 'EQ', 'AP', 'BR', 'AF', 'BM', 'AF', '1', 'AD', 'FA', 'EU', '4', 'DL', 'ED', '15', 'ER', 'AP', 'DS', 'BQ', 'AF', 'DS', 'BQ', 'AF', '2', 'EQ', 'DP', 'AP', 'BM', 'AF', 'BM', 'AF']",['702']
1000,9,521,535,14,0,33,"['EY', '1', 'AA', '7', 'EQ', 'AP', 'BR', 'AF', 'BM', 'AF', '1', 'AD', 'FA', 'EU', '4', 'DL', 'ED', '15', 'ER', 'AP', 'DS', 'BQ', 'AF', 'DS', 'BQ', 'AF', '2', 'EQ', 'DP', 'BM', 'AF', 'BM', 'AF']",['694']
