ID,Sporelayer,Quickener,Generation,Birth_step,Death_step,Lifespan,Sex_check,cgen
1,0,0,0,0,0,0,0,2
2,1,1,1,14,304,290,0,EY_9_AA_9_AA_1_AA_9_AA_2_AA_9_AA_3_AA_9_AA_4_AA_9_AA_5_AA_9_AA_6_AA_9_AA_7_AA_9_AA_8_AA_9_AA_1_ADFAAD_1_APBRAFBM_1_FB_-1_0_APAFAFBMADFC_-1_1_APBRAFBMADFD_1_0_APBRAFBMADFE_1_-1_APBRBRBMADFF_0_1_APBRAFBMADFG_0_-1_APBRAFBMADFH_-1_-1_APBRAFBMADFIEU_4_DLED_-1_0_DSBQAF_-1_0_DSBQAF_1_1_BMAF_0_-1_BMAF_0_-1_BMAF_0_-1_BMAF_0_-1_BMAF_0_-1_BMA
3,2,2,2,29,173,144,0,EY_9_AA_9_AA_1_AA_9_AA_2_AA_9_AA_3_AA_9_AA_4_AA_9_AA_5_AA_9_AA_6_AA_9_AA_7_AA_9_AA_8_AA_9_AA_1_ADFAAD_1_APBRAFBM_1_FB_-1_0_APAFAFBMADFC_-1_1_APBRAFBMADFD_1_0_APBRAFBMADFE_1_-1_APBRBRBMADFF_0_1_APBRAFBMADFG_0_-1_APBRAFBMADFH_-1_-1_APBRAFBMADFIEU_4_DLED_-1_0_DSBQAF_-1_0_DSBQAF_1_1_BMAF_0_-1_BMAF_0_-1_BMAF_0_-1_BMAF_0_-1_BMAF_0_-1_BMA
4,3,3,3,44,928,884,0,EY_9_AA_9_AA_1_AA_9_AA_2_AA_9_AA_3_AA_9_AA_4_AA_9_AA_5_AA_9_AA_6_AA_9_AA_7_AA_9_AA_8_AA_9_AA_1_ADFAAD_1_APBRAFBM_1_FB_-1_0_APAFAFBMADFC_-1_1_APBRAFBMADFD_1_0_APBRAFBMADFE_1_-1_APBRADFF_0_1_APBRAFBMADFG_0_-1_APBRAFBMADFH_-1_-1_APBRAFBMADFIEU_4_DLED_-1_0_DSBQAF_-1_0_DSBQAF_1_1_BMAF_0_-1_BMAF_0_-1_BMAF_0_-1_BMAF_0_-1_BMAF_0_-1_BMA
5,1,1,1,55,0,-55,0,11
6,4,4,4,59,0,-59,0,EY_9_AA_9_AA_1_AA_9_AA_2_AA_9_AA_3_AA_9_AA_4_AA_9_AA_5_AAAA_9_AA_7_AA_9_AA_8_AA_9_AA_1_ADFAAD_1_APBRAFBM_1_FB_-1_0_APAFAFBMADFC_-1_1_APBRAFBMADFD_1_0_APBRAFBMADFE_1_-1_APBRADFF_0_1_APBRAFBMADFG_0_-1_APBRAFBMADFH_-1_-1_APBRAFBMADFIEU_4_DLED_-1_0_DSBQAF_-1_0_DSBQAF_1_1_BMAF_0_-1_BMAF_0_-1_BMAF_0_-1_BMAF_0_-1_BMAF_0_-1_BMA
7,5,5,2,70,500,430,0,11
8,6,6,5,74,189,115,0,13
9,7,7,3,85,549,464,0,11
10,8,8,6,89,204,115,0,13
11,9,9,4,100,0,-100,0,EY_9_AA_9_AA_1_AA_9_AA_2_AA_9_AA_3_AA_9_AA_4_AA_9_AA_5_AA_9_AA_6_AA_9_AA_7_AA_9_AA_8_AA_9_AA_1_ADFA_1_1_APAFBMBMADFB_-1_0_-1_BMAFBMADFC_-1_1_APBRAFBMADFD_1_BRAPBRBRAFADFE_1_-1_AP_0_AFBMADFF_0_1_APBRAFBMADFG_0_-1_APBRAFADFH_-1_-1_APBRAFBMADFIEU_4_DLED_-1_0_DSBQAF_-1_0_DSBQAF_1_1_BMAF_0_-1_BMAF_0_-1_BMAF_0_-1_BMAF_0_APBRAF_0_-1_BMA
12,10,10,7,104,219,115,0,13
13,5,5,2,111,626,515,0,11
14,11,11,5,115,264,149,0,EY_9_AA_9_AA_1_AA_9_AA_2_AA_9_AA_3_AA_9_AA_4_AA_9_AA_5_AA_9_AA_6_AA_9_AA_7_AA_9_AA_8_AA_9_AA_1_ADFA_1_1_APAFBMBMADFB_-1_0_-1_BMAFBMADFC_-1_1_APBRAFBMADFD_1_BRAPBRBRAFADFE_1_-1_AP_0_AFBMADFF_0_1_APBRAFBMADFG_0_-1_APBRAFADFH_-1_-1_APBRAFBMADFIEU_4_DLED_-1_0_DSBQAF_-1_0_DSBQAF_1_1_BMAF_0_-1_BMAF_0_-1_BMAF_0_-1_BMAF_0_APBRAF_0_-1_BMA
15,12,12,8,119,234,115,0,13
16,13,13,3,126,546,420,0,11
17,14,14,6,130,238,108,0,EY_9_AA_9_AA_1_AA_9_AA_2_AA_9_AA_3_AA_9_AA_4_AA_9_AA_5_AA_9_AA_6_AA_9_AA_7_AA_9_AA_8_AA_9_AA_1_ADFA_1_1_APBIDDDMADFB_-1_0_-1_AP_0_AFBMFC_-1_1_APBRAFAPBRFD_1_BRAPBRBRAFADFE_1_-1_BMAFBMADADFF_0_1_BMADAFBMADFG_0_-1_APBRAFADFH_-1_-1_APBRAFBMADFIEU_4_DLED_-1_0_DSBQAF_-1_0_DSBQAF_1_1_BMAF_0_-1_BMAF_0_-1_BMAF_0_-1_BMAF_0_APBRAF_0_-1_BMA
18,15,15,9,134,739,605,0,13
19,16,16,4,141,571,430,0,11
20,17,17,7,145,296,151,0,10
21,18,18,10,149,360,211,0,EY_-1_-1_APBRAFBMADFAAD_1_APBRAFBM_1_FB_-1_0_APAFAFBMADFC_-1_1_APBRAFBMADFD_1_0_APBRAFBMADFE_1_-1_APBRADFF_0_1_APBRAFBMADFG_0_-1_APBRAFBMADFH_9_AA_9_AA_1_AA_9_BW_4_AA_9_AA_3_AA_9_AA_4_AA_9_AA_5_AAAA_9_AA_7_BF_7_EE_8_AA_9_AA_1_ADFIEU_4_DLED_-1_0_DSBQAF_-1_0_DSBQAF_1_1_BMAF_0_-1_BMAF_0_-1_BMAF_0_-1_BMAF_0_-1_BMAF_0_-1_BMA
22,19,19,5,156,636,480,0,EY_9_AA_9_AA_1_AA_9_AA_2_AA_9_AA_3_AA_9_AA_4_AA_9_AA_5_AA_9_AA_6_AA_9_AA_7_AA_9_AA_8_AA_9_AA_1_ADFA_1_1_APBRAFBMADFB_-1_0_-1_BMAFBMADFC_-1_1_APBRAFBMADFD_1_BRAPBRAFBMADFE_1_-1_AP_0_AFBMADFF_0_1_APBRAFBMADFG_0_-1_APFH_-1_-1_APEQAFBMADFIEU_4_DLED_-1_0_DSBQAF_-1_0_DSBQAF_1_1_BMAF_0_-1_BMAF_0_-1_BMAF_0_-1_BMAF_0_APBRAF_0_-1_BMA
23,20,20,8,160,251,91,0,10
24,13,13,3,167,0,-167,0,3
25,22,22,6,171,795,624,0,EY_9_AA_9_AA_1_AA_9_AA_2_AA_9_AA_3_AA_9_AA_4_AA_9_AA_5_AA_9_AA_6_AA_9_AA_7_AA_9_AA_8_AA_9_AA_1_ADFA_1_1_APBRAFBMADFB_-1_0_-1_BMAFBMADFC_-1_1_APBRAFBMADFD_1_BRAPBRAFBMADFE_1_-1_AP_0_AFBMADFF_0_1_APBRAFBMADFG_0_-1_APFH_-1_-1_APEQAFBMADFIEU_4_DLED_-1_0_DSBQAF_-1_0_DSBQAF_1_1_BMAF_0_-1_BMAF_0_-1_BMAF_0_-1_BMAF_0_APBRAF_0_-1_BMA
26,23,23,9,175,352,177,0,10
27,24,24,4,182,0,-182,0,3
28,25,25,7,186,639,453,0,EY_9_AA_9_AA_1_AA_9_AA_2_AA_9_AA_3_AA_9_AA_4_AA_9_AA_5_AA_9_AA_6_AA_9_AA_7_AA_9_AA_8_AA_9_AA_1_ADFA_1_1_APBRAFBMADFB_-1_0_-1_BMAFBMADFC_-1_1_APBRAFBMADFD_1_BRAPBRAFBMADFE_1_-1_AP_0_AFBMADFF_0_1_APBRAFBMADFG_0_-1_APFH_-1_-1_APEQAFBMADFIEU_4_DLED_-1_0_DSBQAF_-1_0_DSBQAF_1_1_BMAF_0_-1_BMAF_0_-1_BMAF_0_-1_BMAF_0_APBRAF_0_-1_BMA
29,18,18,10,190,390,200,0,13
30,26,26,10,190,281,91,0,10
31,27,27,5,197,660,463,0,3
32,28,28,8,201,440,239,0,1
33,30,30,11,205,382,177,0,EY_9_AA_9_AA_1_BMAFAA_2_AA_9_AA_3_AA_9_AA_4_AA_9_AA_5_AA_9_AA_6_AA_9_AA_7_AA_9_AA_8_AA_9_AA_1_ADFA_1_1_APBIDDDMADFB_-1_0_-1_AP_0_AFBMFC_-1_1_APBRAFAPBRFD_1_BRAPBRBRAFADFE_1_-1_BMAFBMADADFF_0_1_BMADAFBMADFG_0_-1_ADFH_-1_-1_APBRAFBMADFIEU_4_DLED_-1_0_DSBQAF_-1_0_DSBQAF_1_1_BMAF_0_-1_BMAF_0_-1_BMAF_0_-1_BMAF_0_APBRAF_0_-1_AA_9
34,29,29,11,205,291,86,0,EY_9_AA_9_AA_1_AA_9_BW_4_AA_9_AA_3_AA_9_AA_4_AA_9_AA_5_AAAA_9_AA_7_AA_9_AA_8_AA_9_7_AA_1_ADFAAD_1_APBRAFBM_1_FB_-1_0_APAFAFBMADFC_-1_1_APBRAFBMADFD_1_0_APBRAFBMADFE_1_-1_APBRADFF_0_1_APBRAFFG_0_-1_APBRAFBMADFH_-1_-1_APBRAFBMADFIEU_4_DLED_-1_0_DSBQAF_-1_0_DSBQAF_1_1_BMAF_0_-1_BMAF_0_-1_BMAF_0_-1_BMAF_0_-1_BMAF_0_-1_BMA
35,31,31,6,212,231,19,0,3
36,32,32,9,216,0,-216,0,1
37,24,24,4,223,640,417,0,3
38,35,35,7,227,629,402,0,3
39,11,11,5,228,602,374,0,EY_9_AA_9_AA_1_AA_9_AA_2_AA_9_AA_3_AA_9_AA_4_AA_9_AA_5_AA_9_AA_6_AA_9_AAAA_9_AA_8_AA_9_AA_1_ADFA_1_1_APAFBMBMADFB_-1_0_-1_BMAFBMADFC_-1_1_APBRAFBMADFD_1_BRAPBRBRAFADFE_1_-1_AP_0_FF_0_1_APBRAFBMADFG_0_-1_APBRAFADFH_-1_-1_APBRAFBMADFIEU_4_DLED_-1_0_DSBQAF_-1_0_DSBQAF_1_1_BMAF_0_-1_BMAF_0_-1_BMAF_0_-1_BMAF_0_APBRAF_0_-1_BMA
40,36,36,10,231,265,34,0,1
41,37,37,5,238,689,451,0,3
42,38,38,8,242,449,207,0,3
43,39,39,6,243,431,188,0,8
44,20,20,8,246,261,15,0,10
45,31,31,6,253,618,365,0,EY_9_AA_9_AA_1_AA_9_AA_2_AA_9_AA_3_AA_9_AA_4_AA_9_AA_5_AA_9_AA_6_AA_9_AA_7_AA_9_AA_8_AA_9_AA_1_ADFA_1_1_APBRAFBMADFB_-1_0_-1_BMAFBMADFC_-1_1_APBRAPFD_1_AFBMADFE_1_-1_AP_0_AFBMADFF_0_1_APBRAFBMADFG_0_-1_ADBRAFBMADFH_-1_-1_APBRAFBMADFIEU_4_DLED_-1_0_DSBQAF_-1_0_DSBQAF_1_1_BMAF_0_-1_BMAF_0_-1_BMAF_0_-1_BMAF_0_APBRAF_0_-1_BMA
46,41,41,6,253,657,404,0,EY_9_AA_9_AA_1_AA_9_AA_2_AA_9_AA_3_AA_9_AA_4_AA_9_AA_5_AA_9_AA_6_AA_9_AA_7_AA_9_AA_8_AA_9_AA_1_ADFA_1_1_APBRAFBMADFB_-1_0_-1_BMAFBMADFC_1_BRAPBRAFBMADFD_1_-1_AP_0_AFBMADFE_0_1_APBRAFBMADFF_0_-1_APBRAFBMADFG_-1_-1_APBRAFBMADFHEU_4_DLED_-1_0_DSBQAF_-1_0_DSBQAF_1_1_BMAF_0_-1_BMAF_0_-1_BMAF_0_-1_BMAF_0_APBRAF_0_-1_BMA
47,42,42,9,257,0,-257,0,EY_9_AA_9_AA_1_AA_9_AA_2_AA_9_AA_3_AA_9_AA_4_AA_9_AA_5_AA_9_AA_6_AA_9_AA_7_AA_9_AA_8_AA_9_AA_1_ADFA_1_4_ASBNBDBMADFB_-1_0_-1_BMAFBMADFC_-1_1_APBRADFD_1_BRAPBRAFBMADFE_1_-1_AP_0_AFBMADFF_0_1_APBRAFBMADFG_0_-1_APBRAFBMADFH_-1_-1_APBRAFBMADFIEU_4_DLED_-1_0_DSBQAF_-1_0_DSBQAF_1_1_BMAF_0_-1_BMAF_0_-1_AF_0_-1_BMAF_0_APBRAF_0_-1_BMA
48,43,43,7,258,588,330,0,EY_9_AA_9_AA_1_AA_9_AA_2_AA_9_AA_3_AA_9_AA_4_AA_9_AA_5_AA_9_AA_6_AA_9_AAAA_9_AA_8_AA_9_AA_1_ADFA_1_1_APAFBMBMADFB_-1_0_-1_BMAFBMADFCAFBMADFD_1_BRAPBRBRAFADFE_1_-1_AP_0_FF_0_1_APBRAFBMADFG_0_-1_APBRAFADFH_1_3_APBRAFBMADFIEU_4_DLED_-1_0_DSBQAF_-1_0_DSBQAF_1_1_BMAF_0_-1_BMAF_0_-1_BMAF_0_-1_BMAF_0_APBR_0_-1_BMA
49,48,48,8,273,584,311,0,EY_9_AA_9_AA_1_AA_9_AA_2_AA_9_AA_3_AA_9_AA_4_AA_9_AA_5_AA_9_AA_6_AA_9_AAAA_9_AA_8_AA_9_AA_1_ADFA_1_1_APAFBMBMADFB_-1_0_-1_BMAFBMADFCAFBMADFD_1_BRAPBRBRAFADFE_1_-1_AP_0_FF_0_1_APBRAFBMADFG_0_-82_53_AI_-1_APBRAFADFH_1_3_APBRAFBMADFIEU_4_DLED_-1_0_DSBQAF_-1_0_DSBQAF_1_1_BMAF_0_-1_BMAF_0_-1_BMAF_0_-1_BMAF_0_APBR_0_-1_BMA
50,26,26,10,276,366,90,0,EY_9_AA_9_AA_1_BMAFAA_2_AA_9_AA_3_AA_9_AA_4_AA_9_AA_5_AA_9_AA_6_AA_9_AA_7_AA_9_AA_8_AA_9_AA_1_ADFA_1_1_APBIDDDMADFB_-1_0_-1_AP_0_AFBMFC_-1_1_APBRAFAPBRFD_1_BRAPBRBRAFADFE_1_-1_BMAFBMADADFF_0_1_BMADAFBMADFG_0_-1_APBRAFADFH_-1_-1_APBRAFBMADADFIEU_4_DLED_-1_0_DSBQAF_-1_0_DSBQAF_1_1_BMAF_0_-1_BMAF_0_-1_BMAF_0_-1_BMAF_0_APBRAF_0_-1_AA_9
51,37,37,5,279,0,-279,0,EY_9_AA_9_AA_1_AA_9_AA_2_AA_9_AA_3_AA_9_AA_4_AA_9_AA_5_AA_9_AA_6_AA_9_AA_7_AA_9_AA_8_AA_9_AA_1_ADFA_1_1_APBRAFBMADFB_-1_0_-1_BMAFBMADFC_-1_1_APBRADFD_1_BRAPBRAFBMADFE_1_-1_AP_0_AFBMADFF_0_1_APBRAFBMFG_0_-1_APBRAFBMADFH_-1_-1_APBRAFBMADFIEU_4_DLED_-1_0_DSBQAF_-1_0_DSBQAF_1_1_BMAF_0_-1_BMAF_0_-1_BMAF_0_-1_BMAF_0_APBRAF_0_-1_BMA
52,38,38,8,283,707,424,0,EY_9_AA_9_AA_1_AA_9_AA_2_AA_9_AA_3_AA_9_AA_4_AA_9_AA_5_AA_9_AA_6_AA_9_AA_7_AA_9_AA_8_AA_9_AA_1_ADFA_1_1_APBRAFBMADFB_-1_0_-1_BMAFBMADFC_-1_1_APBRADFD_1_BRAPBRAFBMADFE_1_-1_AP_0_AFBMADFF_0_1_APBRAFBMADFG_0_-1_APBRAFBMADFH_-1_-1_APBRAFBMADFIEU_4_DLED_-1_0_DSBQAF_54_77_-1_0_DSBQAF_1_1_BMAF_0_-1_BMAF_0_-1_BMAF_0_-1_BMAF_0_APBRAF_0_-1_BMA
53,20,20,8,287,0,-287,0,EY_9_AA_9_AA_1_BMAFAA_2_AA_9_AA_3_AA_9_AA_4_AA_9_AA_5_AA_9_AA_6_AA_9_AA_7_AA_9_AA_8_AA_9_AA_1_ADFA_1_1_APBIDDDMADFB_-1_0_-1_AP_0_AFBMFC_-1_1_APBRAFAPBRFD_1_BRAPBRBRAFADFE_1_-1_BMAFBMADADFF_0_DU_94_DADR_1_BMADAFBMADFG_0_-1_APBRAFADFH_-1_-1_APBRAFBMADFIEU_4_DLED_-1_0_DSBQAF_-1_0_DSBQAF_1_1_BMAF_0_-1_BMAF_0_-1_BMAF_0_-1_BMAF_0_APBRAF_0_-1_AA_9
54,49,49,9,288,418,130,0,EY_8_AA_10_AA_0_AA_12_AA_3_AA_7_AA_-3_AA_6_AA_6_AA_10_AA_8_AA_-9_AA_-6_AA_13_AAAA_13_AA_11_AA_12_AA_-2_ADFA_1_1_APAFBMBMADFB_-1_0_-1_BMAFBMADFCAFBMADFD_1_BRAPBRBRAFADBRBRAFFEFF_0_1_APBRAFBMADFG_0_-82_53_AI_-1_APBRAFADFH_1_3_APBMADFIEU_4_DLED_-1_0_DSBQAF_-1_0_DSBQAF_1_1_BMAF_0_-1_BMAF_0_-1_BMAF_0_-1_BMAF_0_APBR_0_-1_BMA
55,50,50,11,291,587,296,0,EY_9_AA_9_AA_1_BMAFAA_2_AA_9_AA_3_AA_9_AA_4_AA_9_AA_5_AA_9_AA_6_AA_9_AA_7_AA_9_AA_8_AA_9_AA_1_ADFA_1_1_APBIDDDMADFB_-1_0_-1_AP_0_AFBMFC_-1_1_APBRAFAPBRFD_1_BRAPBRBRAFADFE_1_-1_BMAFBMADADFF_0_1_BMADAFBMADFG_0_-1_APBRAFADFH_-1_-1_APBRAFBMADADFIEU_4_DLED_-1_0_DSBQAF_-1_0_DSBQAF_1_1_BMAF_0_-1_BMAF_0_-1_BMAF_0_-1_BMAF_0_APBRAF_0_-1_AA_9
56,41,41,6,294,0,-294,0,EY_9_AA_9_AA_1_AA_9_AA_2_AA_9_AA_3_AA_9_AA_4_AA_9_AA_5_AA_9_AA_6_AA_9_AA_7_AA_9_AA_8_AA_9_AA_1_ADFA_1_1_APBRAFBMADFB_-1_0_-1_BMAFBMADFC_-1_1_APBRADFD_1_BRAPBRAFBMADFE_1_-1_AP_0_AFBMADFF_0_1_APBRAFBMADFG_-1_APBRAFAFBMADFH_-1_0_-1_APBRBMADFIEU_4_DLED_-1_0_DSBQAF_-1_0_DSBQAF_1_1_BMAF_0_-1_BMAF_0_-1_BMAF_0_-1_BMAF_0_APBRAF_0_-1_BMA
57,51,51,6,294,0,-294,0,EY_9_AA_9_AA_1_AA_9_AA_2_AA_9_AA_3_AA_9_AA_4_AA_9_AA_5_AA_9_AA_6_AA_9_AA_7_AA_9_AA_8_AA_9_AA_1_ADFA_1_1_APBRAFBMADFB_-1_0_-1_BMAFBMADFC_-1_1_APBRADFD_1_BRAPBRAFBMADFE_1_-1_AP_0_AFBMADFF_0_1_APBRAFBMFG_0_-1_APBRAFBMADFH_-1_-1_APBRAFBMADFIEU_4_DLED_-1_0_DSBQAF_-1_0_DSBQAF_1_1_BMAF_0_-1_BMAF_0_-1_BMAF_0_-1_BMAF_0_APBRAF_0_-1_BMA
58,43,43,7,299,542,243,0,8
59,33,33,12,306,0,-306,0,EY_9_AA_9_AA_1_BMAFAA_2_AA_9_AA_3_AA_9_AA_4_AA_9_AA_5_AA_9_AA_6_AA_9_AA_7_AA_9_AA_8_AA_9_AA_1_ADFA_1_1_APBIDDDMADFB_-1_0_-1_AP_0_AFBMFC_-1_1_APBRAFAPBRFDBRAFAD_1_BRAPBRBRAFADFE_1_-1_BMAFBMADADFF_0_1_BMADAFBMADFG_0_-1_ADFH_-1_-1_APBRAFBMADFIEU_4_DLED_-1_0_DSBQAF_-1_0_DSBQAF_1_1_BMAF_0_-1_BMAF_0_-1_BMAF_0_-1_BMAF_0_APBRAF_0_-1_AA_9
60,45,45,7,309,381,72,0,EY_9_AA_9_AA_1_AA_9_AA_2_AA_9_AA_3_AA_9_AA_4_AA_9_AA_5_AA_9_AA_6_AA_9_AA_7_AA_9_AA_8_AA_9_AA_1_ADFA_1_1_APBRAFBMADFB_-1_0_-1_BMAFBMADFC_-1_1_APBRAPFD_1_AFBMADFE_1_-1_AP_0_AFBMADFF_0_1_APBRAFBMADFG_0_-1_ADBRAFBMADFH_-1_-1_APBRAFBMADFIEU_4_DLED_-1_0_DSBQAF_-1_0_DSBQAF_1_1_BMAF_0_-1_BMAF_0_-1_BMAF_0_-1_BMAF_0_APBRAF_0_-1_BMA
61,57,57,7,309,0,-309,0,EY_9_AA_9_AA_1_AA_9_AA_2_AA_9_AA_3_AA_9_AA_4_AA_9_AA_5_AA_9_AA_6_AA_9_AA_7_AA_9_AA_8_AA_9_AA_1_ADFA_1_1_APBRAFBMADFB_-1_0_-1_BMAFBMADFC_-1_1_APBRADFD_1_BRAPBRAFBMADFE_1_-1_AP_0_AFBMADFFBRAFBMFG_0_-1_APBRAFBMADFH_-1_-1_APBRAFBMADFIEU_4_DLED_-1_0_DSBQAF_-1_0_DSBQAF_1_1_BMAF_0_-1_BMAF_0_-1_BMAF_0_-1_BMAF_0_APBRAF_0_-1_BMA
62,58,58,8,314,599,285,0,8
63,26,26,10,317,580,263,0,10
64,60,60,8,324,660,336,0,EY_9_AA_9_AA_1_AA_9_AA_2_AA_9_AA_3_AA_9_AA_4_AA_9_AA_5_AA_9_AA_6_AA_9_AA_7_AA_9_AA_8_AA_9_AA_1_ADFA_1_1_APBRAFBMADFB_-1_0_-1_BMAFBMADFC_-1_1_APBRAPFD_1_AFBMADFE_1_-1_AP_0_AFBMADFF_0_1_APBRAFBMADFG_0_-1_ADBRAFBMADFH_-1_-1_APBRAFBMADFIEU_4_DLED_-1_0_DSBQAF_-1_0_DSBQAF_1_1_BMAF_0_-1_BMAF_0_-1_BMAF_0_-1_BMAF_0_APBRAF_0_-1_BMA
65,62,62,9,329,0,-329,0,8
66,63,63,11,332,681,349,0,10
67,51,51,6,335,754,419,0,EY_9_AA_9_AA_1_AA_9_AA_2_AA_9_AA_3_AA_9_AA_4_AA_9_AA_5_AA_9_AA_6_AA_9_AA_7_AA_9_AA_8_AA_9_AA_1_ADFA_1_1_APBRAFBMADFB_-1_0_-1_BMAFBMADFC_-1_FD_1_BRAPBRAFBMADFE_1_-1_AP_0_AFBMADFF_0_1_APBRAFBMFG_0_-1_APBRAFBMADFH_-1_-1_APBRAFBMADFIEU_4_DLED_-1_0_DSBQAF_-1_0_DSBQAF_1_1_BMAF_0_-1_BMAF_0_-1_BMAF_0_-1_BMAF_0_APBRAF_0_-1_BMA
68,36,36,10,337,800,463,0,1
69,53,53,9,343,564,221,0,EY_9_AA_9_AA_1_BMAFAA_2_AA_9_AA_3_AA_9_AA_4_AA_9_AA_5_AA_9_AA_6_AA_9_AA_7_AA_9_AA_8_AA_9_AA_1_ADFA_1_1_APBIDDDMADFB_-1_0_-1_AP_0_AFBMFC_-1_1_APBRAFAPBRFD_1_BRAPBRBRAFADFE_1_-1_BMAFBMADADFF_0_DU_94_DADR_1_BMADAFBMADFG_0_-1_APBRAFADFH_-1_-1_APBRAFBMADFIEU_4_DLED_-1_0_DSBQAF_-1_0_DSBQAF_1_1_BMAF_0_-1_BMAF_0_-1_BMAF_0_-1_BMAF_0_APBRAF_0_-1_AA_9
70,56,56,7,350,674,324,0,EY_9_AA_9_AA_1_AA_9_AA_2_AA_9_AA_3_AA_9_AA_4_AA_9_AA_5_AA_9_AA_6_AA_9_AA_7_AA_9_AA_8_AA_9_AA_1_ADFA_1_1_APBRAFBMADFB_-1_0_-1_BMAFBMADFC_-1_1_APBRADFD_1_BRAPBRAFBMADFE_1_-1_AP_0_AFBMADFF_0_1_APBRAFBMADFG_-1_APBRAFAFBMADFH_-1_0_-1_APBRBMADFIEU_4_DLED_-1_0_DSBQAF_-1_0_DSBQAF_1_1_BMAF_0_-1_BMAF_0_-1_BMAF_0_-1_BMAF_0_APBRAF_0_-1_BMA
71,68,68,11,352,0,-352,0,EY_9_AA_9_AA_1_AA_9_AA_2_AA_9_AA_3_AA_9_AA_4_AA_9_AA_5_AA_6_AA_9_AA_7_AA_9_AA_8_AA_9_AA_1_ADFA_1_1_APBRAFBMADFB_-1_0_-1_BMAFBMADFC_-1_1_APBRAFBMADFD_1_BRAPBRAFBMADFE_1_AP_0_AFBM_-1_AP_0_AFBMADFF_0_1_APBRAFBMADFG_0_-1_APFH_-1_-1_APEQAFBMADFIEU_4_DLED_-1_0_DSBQAF_-1_0_DSBQAF_1_1_BMAF_0_-1_BMAF_0_-1_BMAF_0_-1_BMAF_0_APBRAF_0_-1_BMA
72,32,32,9,357,0,-357,0,1
73,1,1,1,358,0,-358,0,2
74,69,69,10,358,502,144,0,EY_9_AA_9_AA_1_BMAFAA_2_AA_9_AA_3_AA_9_AA_4_AA_9_AA_5_AA_9_AA_6_AA_9_AA_7_AA_9_AA_8_AA_9_1_ADFA_1_1_APBIDDDMADFB_-1_0_-1_AP_0_AFBMFC_-1_1_APBRAFAPBRFD_1_BRAPBRBRAFADFE_1_-1_BMAFBMADADFF_0_DU_94_DADR_1_BMADAFBMADFG_0_-1_APBRAFADFH_-1_-1_APBRAFBMADFIEU_4_DLED_-1_0_DSBQAF_-1_0_DSBQAF_1_1_BMAF_0_-1_BMAF_0_-1_BMAF_0_-1_BMAF_0_APBRAF_0_-1_AA_9
75,72,72,10,372,813,441,0,EY_9_AA_9_AA_1_AA_9_AA_2_AA_9_AA_3_AA_9_AA_4_AA_9_AA_5_AA_9_AA_6_AA_9_AA_7_AA_9_AA_8_AA_9_AA_1_ADFA_1_1_APBRAFBMADFB_-1_0_-1_BMAFBMADFC_-1_1_APBRAFBMADFD_1_BRAPBRAFBMADFE_1_AP_0_AFBM_-1_AP_0_AFBMADFF_0_1_APBRAFBMADFG_0_-1_APFH_-1_-1_ADFIEU_4_DLED_-1_0_AF_-1_DSBQ_0_DSBQAF_1_1_BMAF_0_-1_BMAF_0_-1_BMAF_0_-1_BMAF_0_APBRAF_0_-1_BMA
76,74,74,11,373,517,144,0,EY_9_AA_9_AA_1_BMAFAA_2_AA_9_AA_3_AA_9_AA_4_AA_9_AA_5_AA_9_AA_6_AA_9_AA_7_AA_9_AA_8_AA_9_1_ADFA_1_1_APBIDDDMADFB_-1_-1_AP_0_AFBMFC_-1_1_APBRAFAPBRFD_1_BRAPBRBRAFADFE_1_-1_BMAFBMADADFF_0_DU_94_DADR_1_BMADAFBMADFG_0_-1_APBRAFADFH_-1_-1_APBRAFBMADFIEU_4_DLED_-1_0_DSBQAF_-1_0_DSBQAF_1_1_BMAF_0_-1_BMAF_0_-1_BMAF_0_-1_BMAF_0_APBRAF_0_-1_AA_9
77,73,73,2,373,0,-373,0,EY_9_AA_9_AA_1_AA_9_AA_2_AA_9_AA_3_AA_9_AA_4_AA_9_AA_5_AA_9_AA_6_AA_9_AA_7_AA_9_AA_8_AA_9_AA_1_ADFA_-1_0_APBRAFBMADFB_-1_1_APBRAFBMADFC_1_-1_APBRAFBMADFD_0_1_APBRAFBMADFE_0_-1_APBRADFF_-1_-1_APBRAFBMADFGEU_4_DLED_-1_0_DSBQAF_-1_0_DSBQAF_1_1_BMAF_0_-1_BMAF_0_-1_BMAF_0_-1_BMAF_0_-1_BMAF_0_-1_BMA
78,71,55,12,387,570,183,-16,EY_9_AA_9_AA_1_AA_9_AA_2_AA_9_AA_3_AA_9_AA_4_AA_9_AA_5_AA_6_AA_9_AA_7_AA_9_AA_8_AA_9_AA_1_ADFA_1_1_APBIDDDMADFB_-1_0_-1_AP_0_AFBMFC_-1_1_APBRAFAPBRFD_1_BRAPBRBRAFADFE_1_-1_BMAFBMADADFF_0_1_APBRAFBMADFG_0_-1_APFH_-1_-1_APEQAFBMADFIEU_4_DLED_-1_0_DSBQAF_-1_0_DSBQAF_1_1_BMAF_0_-1_BMAF_0_-1_BMAF_0_-1_BMAF_0_APBRAF_0_-1_BMA
79,53,53,9,388,520,132,0,EY_9_AA_9_AA_1_BMAFAA_2_AA_9_AA_3_AA_9_AA_4_AA_9_AA_5_AA_9_AA_6_AA_9_AA_7_AA_9_AA_8_AA_9_AA_1_ADFA_1_1_APBIDDDMADFB_-1_0_-1_AP_0_AFBMFC_-1_1_APBRAFAPBRFD_1_BRAPBRBRAFADFE_1_-1_BMAFBMADADFF_0_DU_94_DADR_1_BMADAFBMADFG_0_-1_APBRAFADFH_-1_-1_APBRAFBMADFIEU_4_DLED_-1_0_DSBQAF_-1_0_DSBQAF_1_1_BMAF_0_-1_BMAF_0_-1_BMAF_0_-1_BMAF_0_APBRAF_0_-1_AA_9
80,68,68,11,393,0,-393,0,1
81,78,78,13,402,483,81,0,EY_9_AA_9_AA_1_AA_9_AA_2_AA_9_AA_3_AA_9_AA_4_AA_9_AA_5_AA_6_AA_9_AA_7_AA_9_AA_8_AA_9_AA_1_ADFA_1_1_APBIDDDMADFB_-1_0_-1_AP_0_AFBMFC_-1_1_APBRAFAPBRFD_1_BRAPBRBRAFADFE_1_-1_BMAFBMADADFF_0_1_APBRAFBMADFG_0_-1_APFH_-1_-1_APEQAFBMADFIEU_4_DLED_-1_0_DSBQAF_-1_0_DSBQAF_1_1_BMAF_0_-1_BMAF_0_-1_BMAF_0_-1_BMAF_0_APBRAF_0_-1_BMA
82,43,43,7,406,545,139,0,8
83,5,5,2,407,0,-407,0,11
84,59,59,13,407,611,204,0,EY_9_AA_9_AA_1_BMAFAA_2_AA_9_AA_3_AA_9_AA_4_AA_9_AA_5_AA_9_AA_6_AA_9_AA_7_AA_9_AA_8_AA_9_AA_1_ADFA_1_1_APBIDDDMADFB_-1_0_-1_BMADAFBMFC_-1_1_APBRAFAPBRFDBRAFAD_1_BRAPBRBRAFADFE_1_-1_BMAFAP_0_ADFF_0_1_BMEOAFBMADFG_0_-1_ADFH_-1_-1_APBRAFBMADFIEU_4_DLED_-1_0_DSBQAF_-1_0_DSBQAF_1_1_BMAF_0_-1_BMAF_0_-1_BMAF_0_-1_BMAF_0_APBRAF_0_-1_AA_9
85,71,71,12,408,0,-408,0,4
86,80,80,12,408,847,439,0,EY_9_AA_9_AA_1_AA_9_AA_2_AA_9_AA_3_AA_9_AA_4_AA_9_AA_5_AA_9_AA_6_AA_9_AA_7_AA_9_AA_8_AA_9_AA_1_ADFA_1_1_APBRAFBMADFB_-1_0_-1_BMAFBMADFC_-1_1_APBRAFBMADFD_1_BRAFBMAPBRAFBMADFE_1_AP_0_AFBM_-1_AP_0_AFBMADFF_0_1_APBRAFBMADFG_0_-1_FH_-1_-1_APEQAFBMADFIEU_4_DLED_-1_0_DSBQAF_-1_0_DSBQAF_1_1_BMAF_0_-1_BMAF_0_-1_BMAF_0_-1_BMAF_0_APBRAF_0_-1_BMA
87,72,72,10,413,445,32,0,EY_9_AA_9_AA_1_AA_9_AA_2_AA_9_AA_3_AA_9_AA_4_AA_9_AA_5_AA_9_AA_6_AA_9_AA_7_AA_9_AA_8_AA_9_AA_1_ADFA_1_1_APBRAFBMADFB_-1_0_-1_BMAFBMADFC_-1_1_APBRAFBMADFD_1_BRAPBRAFBMADFE_1_AP_0_AFBM_-1_AP_0_AFBMADFF_0_1_APBRAFBMADFG_0_-1_APFH_-1_-1_APEQAFBMADFIEU_4_DLED_-1_0_DSBQAF_-1_0_DSBQAF_1_0_-1_BMAF_0_-1_BMAF_0_-1_BMAF_0_APBRAF_0_-1_BMA
88,73,73,2,414,443,29,0,2
89,81,81,14,417,958,541,0,EY_9_AA_9_AA_1_AA_9_AA_2_AA_9_AA_3_AA_9_AA_4_AA_9_BB_8_DN_2_AA_9_AA_7_AA_9_AA_8_AA_9_AA_1_ADFA_1_1_APBIDDDMADFB_-1_0_-1_AP_0_AFBMFC_-1_1_APBRAFAPBRFD_1_BRAPBRBRAFADFE_1_-1_BMAFBMADADFF_0_1_APBRAFBMADFG_0_-1_APFH_-1_-1_APEQAFBMADFIEU_4_DLED_-1_0_DSBQAF_-1_0_DSBQAF_1_1_BMAF_0_-1_BMAF_0_-1_BMAF_0_-1_BMAF_0_APBRAF_0_-1_BMA
90,82,82,8,421,653,232,0,8
91,84,84,14,422,0,-422,0,0
92,83,83,3,422,451,29,0,EY_9_AA_9_AA_1_AA_9_AA_2_AA_9_AA_3_AA_9_AA_4_AA_9_AA_5_AA_9_AA_6_AA_9_AA_7_AA_9_AA_8_AA_9_AA_1_ADFA_-1_0_-1_BMAFBMADFB_1_1_APBRAFBMADFC_-1_1_APBRAFBMADFD_1_BRAPBRAFBMADFE_1_-1_AP_0_AFBMADFF_0_1_APBRAFBMADFG_0_-1_APBRAFBMADFH_-1_-1_APBRAFBMADFIEU_4_DLED_-1_0_DSBQAF_-1_0_DSBQAF_1_1_BMAF_0_-1_BMAF_0_-1_BMAF_0_-1_BMAF_0_APBRAF_0_-1_BMA
93,86,86,13,423,898,475,0,EY_9_AA_9_AA_1_AA_9_AA_2_AA_9_AA_3_AA_9_AA_4_AA_9_AA_5_AA_9_AA_6_AA_9_AA_7_AA_9_AA_8_AA_9_AA_1_ADFA_1_1_APBRAFBMADFB_-1_0_-1_BMAFBMADFC_-1_1_APBRAFBMADFD_1_BRAFBMAPBRAFBMADFE_1_AP_0_AFBM_-1_AP_0_AFBMADFF_0_1_APBRAFBMADFG_0_-1_-1_FH_-1_-1_APEQAFBMADFIEU_4_DLED_-1_0_DSBQAF_-1_0_DSBQAF_1_1_BMAF_0_-1_BMAF_0_-1_BMAF_0_-1_BMAF_0_APBRAF_0_-1_BMA
94,49,87,11,423,683,260,38,EY_1_1_APBRAFBMADFA_9_AA_9_AA_1_AA_9_AA_2_AA_9_AA_3_AA_9_AA_4_AA_9_AA_5_AA_9_AA_6_AA_9_AA_7_AA_9_AA_8_AA_9_AA_1_ADFB_-1_0_-1_BMAFBMADFC_-1_1_APBRAFBMADFD_1_BRAPBRAFBMADFE_1_-1_AP_0_FF_0_1_APBRAFBMADFG_0_-82_53_AI_-1_APBRAFADFH_-1_-1_APEQAFBMADFIEU_4_DLED_-1_0_DSBQAF_-1_0_DSBQAF_1_1_BMAF_0_-1_BMAF_0_-1_BMAF_0_-1_BMAF_0_APBR_0_-1_BMA
95,88,88,3,429,626,197,0,2
96,89,89,15,432,875,443,0,EY_9_AA_9_AA_1_AA_9_AA_2_AA_9_AA_3_AA_9_AA_4_AA_9_BB_8_DN_2_AA_9_AA_7_AA_9_AA_8_AA_9_AA_1_ADFA_1_1_APBIDDDMADFB_-1_0_AP_0_AFBMFC_-1_1_APBRAFAPBRFD_1_BRAPBRBRAFADFE_1_-1_BMAFBMADADFF_0_1_APBRAFBMADFG_0_-1_APFH_-1_-1_APEQAFBMADFIEU_4_DLED_-1_0_DSBQAF_-1_0_DSBQAF_1_1_BMAF_0_-1_BMAF_0_-1_BMAF_0_-1_BMAF_0_APBRAF_0_-1_BMA
97,92,92,4,437,493,56,0,EY_9_AA_9_AA_1_AA_9_AA_2_AA_9_AA_3_AAAA_9_AA_5_AA_9_AA_6_AA_9_AA_7_AA_9_AA_8_AA_9_AA_1_ADFA_-1_0_-1_BMAFBMADFB_1_1_APBRAFBMADFC_-1_1_APBRAFBMADFD_1_BRAPBRAFBMADFE_1_-1_AP_0_AFBMADFF_0_1_APBRAFBMADFG_0_-1_APBRAFBMADFHEU_4_DLED_-1_0_DSBQAF_-1_0_DSBQAF_1_1_BMAF_0_-1_BMAF_0_-1_BMAF_0_-1_BMAF_0_APBRAF_0_-1_BMA
98,93,93,14,438,489,51,0,EY_9_AA_9_AA_1_AA_9_AA_2_AA_9_AA_3_AA_9_AA_4_AA_9_AA_5_AA_9_AA_6_AA_9_AA_7_AA_9_AA_8_AA_9_AA_1_ADFA_1_1_APBRAFBMADFB_-1_0_-1_BMAFBMADFC_-1_1_APBRAFBMADFD_1_BRAFBMAPBRAFBMADFE_1_AP_0_AFBM_-1_AP_0_AFBMADFF_0_1_APBRAFBMADFG_0_-1_-1_FH_-1_-1_APEQAFBMADFIEU_4_DLED_-1_0_DSBQAF_-1_0_DSBQAF_1_1_BMAF_0_-1_BMAF_0_-1_BMAF_0_-1_BMAF_0_APBRAF_0_-1_BMA
99,79,79,10,444,621,177,0,EY_9_AA_9_AA_1_BMAFAA_2_AA_9_AA_3_AA_9_AA_4_AA_9_AA_5_AA_9_AA_6_AA_9_AA_7_AA_9_AA_8_AA_9_AA_1_ADFA_1_1_APBIDDDMADFB_-1_0_-1_AP_0_AFBMFC_-1_1_APBRAFAPBRFD_1_BRAPBRBRAFADFE_1_-1_BMAFBMADADFF_0_DU_94_DADR_1_BMADAFBMADFG_0_-1_APBRAFADFH_-1_-1_APBRAFBMADFIEU_4_DLED_-1_0_DSBQAF_-1_0_DSBQAF_1_1_BMAF_0_-1_BMAF_0_-1_BMAF_0_-1_BMAF_0_APBRAF_0_-1_AA_9
100,95,95,4,444,690,246,0,2
101,96,96,16,447,876,429,0,EY_9_AA_9_AA_1_AA_9_AA_2_AA_9_AA_3_AA_9_AA_4_AA_9_BB_8_DN_2_AA_9_AA_7_AA_9_AA_8_AA_9_AA_1_ADFA_1_1_APBIDDDMADFB_-1_0_AP_0_AFBMFC_-1_1_APBRAFAPBRFD_1_BRAPBRBRAFADFE_1_-1_BMAFBM_-10_ADADFF_0_1_APBRAFBMADFG_0_-1_APFH_-1_-1_APEQAFBMADFIEU_4_DLED_-1_0_DSBQAF_-1_0_DSBQAF_1_1_BMAF_0_-1_BMAF_0_-1_BMAF_0_-1_BMAF_0_APBRAF_0_-1_BMA
102,80,80,12,449,495,46,0,9
103,9,9,4,451,536,85,0,EY_9_AA_9_AA_1_AA_9_AA_2_AA_9_AA_3_AA_9_AA_4_AA_9_AA_5_AA_9_AA_6_AA_9_AA_7_AA_9_AA_8_AA_9_AA_1_ADFA_1_1_APBRAFBMADFB_-1_0_-1_BMAFBMADFC_-1_1_APBRAFBMADFD_1_BRAPBRAFBMADFE_1_-1_AP_0_AFBMADFF_0_1_APBRAFBMADFG_0_-1_APBRAFBMADFH_-1_-1_APBR_-1_0_DSFIEU_4_DLED_-1_0_DSBQAFAFBMADBQAF_1_1_BMAF_0_-1_BMAF_0_-1_BMAF_0_-1_BMAF_0_APBRAF_0_-1_BMA
104,98,98,15,453,865,412,0,EY_9_AA_9_AA_1_AA_9_AA_2_AA_9_AA_3_AA_9_AA_4_AA_9_AA_5_AA_9_AA_6_AA_9_AA_7_AA_9_AA_8_AAFA_1_1_APBRAFBMADFB_-1_0_-1_BMAFBMADFC_-1_1_APBRAFBMADFD_1_BRAFBMAPBRAFBMADFE_1_AP_0_AFBM_-1_AP_0_AFBMADFF_0_1_APBRAFBMADFG_0_-1_-1_FH_-1_-1_APEQAFBMADFIEU_4_DLED_-1_0_DSBQAF_-1_0_DSBQAF_1_1_BMAF_0_-1_BMAF_0_-1_BMAF_0_-1_BMAF_0_APBRAF_0_-1_BMA
105,39,39,6,454,576,122,0,EY_9_AA_9_AA_1_AA_9_AA_2_AA_9_AA_3_AA_9_AA_4_AA_9_AA_5_AA_9_AA_6_AA_9_AAAA_9_AA_8_AA_9_AA_1_ADFA_1_1_APAFBMBMADFB_-1_0_-1_BMAFBMADFC_-1_1_APBRAFBMADFD_1_BRAPBRBRAFADFE_1_-1_AP_0_FF_0_1_APBRAFBMADFG_0_-1_APBRAFADFH_-1_-1_APBRAFBMADFIEU_4_DLED_-1_0_DSBQAF_-1_0_DSBQAF_1_1_BMAF_0_-1_BMAF_0_-1_BMAF_0_-1_BMAF_0_APBRAF_0_-1_BMA
106,100,100,5,459,459,0,0,2
107,101,101,17,462,877,415,0,EY_9_AA_9_AA_1_AA_9_AA_2_AA_9_AA_3_AA_9_AA_4_AA_9_BB_8_DN_2_AA_9_AA_7_AA_9_AA_8_AA_9_AA_1_ADFA_1_1_APBIDDDMADFB_-1_0_AP_0_AFBMFC_-1_1_APBRAFAPBRFD_1_BRAPBRBRAFADFE_1_-1_BMAFBM_-10_ADADFF_0_1_APBRAFBMADFG_0_-1_APFH_-1_-1_APEQAFBMADFIEU_4_DLED_-1_0_DSBQAF_-1_0_DSBQAF_1_1_BMAF_0_-1_BMAF_0_-1_BMAF_0_-1_BMAF_0_APBRAF_0_-1_BMA
108,83,83,3,463,552,89,0,EY_9_AA_9_AA_1_AA_9_AA_2_AA_9_AA_3_AA_9_AA_4_AA_9_AA_5_AA_9_AA_6_AA_9_AA_7_AA_9_AA_8_AA_9_AA_1_ADFA_1_1_APBRAFBMADFB_-1_0_-1_BMAFBMADFC_-1_1_APBRAFBMADFD_1_BRAPBRAFBMADFE_1_-1_AP_0_AFBMADFF_0_-1_APBRAFBMADFG_-1_-1_APBRAFBMADFHEU_4_DLED_-1_0_DSBQAF_-1_0_DSBQAF_1_1_BMAF_0_-1_BMAF_0_-1_BMAF_0_-1_BMAF_0_APBRAF_0_-1_BMA
109,85,85,13,464,918,454,0,4
110,102,102,13,464,890,426,0,9
111,104,104,16,468,934,466,0,EY_9_AA_9_AA_1_AA_9_AA_2_AA_9_AA_3_AA_9_AA_4_AA_9_AA_5_AA_9_AA_6_AA_9_AA_7_AA_9_AA_8_AAFA_1_1_APBRAFBMADFB_-1_0_-1_BMAFBMADFC_-1_1_APBRAFBMADFD_1_BRAFBMAPBRAFBMADFE_1_AP_0_AFBM_-1_AP_0_AFBMADFF_0_1_APBRAFBMADFG_0_-1_-1_FH_-1_-1_APEQAFBMADFIEU_4_DLED_-1_0_DSBQAF_-1_0_DSBQAF_1_1_BMAF_0_-1_BMAF_0_-1_BMAF_0_-1_BMAF_0_APBRAF_0_-1_BMA
112,58,58,8,469,605,136,0,8
113,53,53,9,474,565,91,0,EY_9_AA_9_AA_1_BMAFAA_2_AA_9_AA_3_AA_9_AA_4_AA_9_AA_5_AA_9_AA_6_AA_9_AA_7_AA_9_AA_8_AA_9_AA_1_ADFA_1_1_APBIDDDMADFB_-1_0_-1_AP_0_AFBMFC_-1_1_APBRAFAPBRFD_1_BRAPADFE_1_-1_BMAFBMADADFF_0_DU_94_DADR_1_BMADAFBMADFG_0_-1_APBRAFADFH_-1_-1_APBRAFBMADFIEU_4_DLED_-1_0_DSBQAF_-1_0_DSBQAF_1_1_BMAF_0_-1_BMAF_0_-1_BMAF_0_-1_BMAF_0_APBRAF_0_-1_AA_9
114,107,107,18,477,892,415,0,EY_9_AA_9_AA_1_AA_9_AA_2_AA_9_AA_3_AA_9_AA_4_AA_9_BB_8_DN_2_AA_9_AA_7_AA_9_AA_8_AA_9_AA_1_ADFA_1_1_APBIDDDMADFB_-1_0_AP_0_AFBMFC_-1_1_APBRAFAPBRFD_1_BRAPBRBRAFADFE_2_-3_BMAFBM_-9_ADADFF_0_1_APBRAFBMADFG_0_-1_APFH_-1_-1_APEQAFBMADFIEU_4_DLED_-1_0_DSBQAF_-1_0_DSBQAF_1_1_BMAF_0_-1_BMAF_0_-1_BMAF_0_-1_BMAF_0_APBRAF_0_-1_BMA
115,110,110,14,479,0,-479,0,EY_9_AA_9_AA_1_AA_9_AA_2_AA_9_AA_3_AA_9_AA_4_AA_9_AA_5_AA_9_AA_6_AA_9_AA_7_AA_9_AA_8_AA_9_AA_1_ADFA_1_1_APBRAFBMADFB_-1_0_-1_BMAFBMADFC_-1_1_APBRAFBMADFD_2_BRAPBRAFBMADFE_1_AP_0_AFBM_-1_AP_0_AFBMADFF_1_APBRAF_0_1_APBRAFBMADFG_0_-1_APFH_-1_-1_APEQAFBMADFIEU_4_DLED_-1_0_DSBQAF_-1_0_DSBQAF_1_1_BMAF_0_-1_BMAF_0_-1_BMAF_0_-1_BMAF_0_APBRAF_0_-1_BMA
116,109,109,14,479,497,18,0,EY_9_AA_9_AA_1_AA_9_AA_2_AA_9_AA_3_AA_9_AA_4_AA_9_AA_5_AA_6_AA_9_AA_7_AA_9_AA_8_AA_9_AA_1_ADFA_1_1_APBRAFBMADFB_-1_0_-1_BMAFBMADFC_-1_1_APBRAFBMADFD_1_BRBMADAFBMADFE_0_1_APBRAFAPBRFF_0_-1_APFG_-1_-1_APEQAFBMADFHEU_4_DLED_-1_0_DSBQAF_-1_0_DSBQAF_1_1_BMAF_0_-1_BMAF_0_-1_BMAF_0_-1_BMAF_0_APBRAF_0_-1_BMA
117,48,48,8,482,855,373,0,EY_9_AA_9_AA_1_AA_9_AA_2_AA_9_AA_3_AA_9_AA_4_AA_9_AA_5_AA_9_AA_6_AA_9_AAAA_9_AA_8_AA_9_AA_1_ADFA_1_1_APAFBMBMADFB_-1_0_-1_BMAFBMADFCAFBMADFD_1_BRAPBRBRAFADFE_1_-1_AP_0_FF_0_1_APBRAFBMADFG_0_-1_APBRADFH_1_3_APBRAFBMADFIEU_4_DLED_-1_0_DSBQAF_-1_0_DSBQAF_1_1_BMAF_0_-1_BMAF_0_-1_BMAF_0_-1_BMAF_0_APBR_0_-1_BMA
118,111,111,17,483,905,422,0,EY_9_AA_9_AA_1_AA_9_AA_2_AA_9_AA_3_AA_9_AA_4_AA_9_AA_5_AA_9_AA_6_AA_9_AA_7_AA_9_AA_8_AAFA_1_1_APBRAFBMADFB_-1_0_-1_BMAFBMADFC_-1_1_APBRAFBMADFD_1_BRAFBMAPBRAFBMADFE_1_AP_0_AFBM_-1_AP_0_AFBMADFF_0_1_APBRAFBMADFG_0_-1_-1_FH_-1_-1_APEQAFBMADFIEU_4_DLED_-1_0_DSBQAF_-1_0_DSBQAF_1_1_BMAF_0_-1_BMAF_0_-1_BMAF_0_-1_BMAF_0_APBRAF_0_-1_BMA
119,95,95,4,485,719,234,0,2
120,73,73,2,486,747,261,0,EY_9_AA_9_AA_1_AA_9_AA_2_AA_9_AA_3_AA_9_AA_4_AA_9_AA_5_AA_9_AAAA_7_AA_9_AA_8_AA_9_AA_1_ADFA_1_1_BEBOBEEOADFB_-1_0_APBRAFBMADFC_-1_1_APBRAFBMADFD_1_0_APBRAFBMADFE_1_-1_APBRAFBMADAFFF_0_1_APBRAFBMADFG_0_-1_APBRAFBMADFH_-1_-1_AP_33_-10_BRAFBMADFIEU_4_DLED_-1_0_DSBQAF_-1_0_DSBQAF_1_1_BMAF_0_-1_BMAF_0_-1_BMAF_0_-1_BMAF_0_-1_BMAF_0_-1_BMA
121,96,96,16,488,903,415,0,EY_9_AA_9_AA_1_AA_9_AA_2_AA_9_AA_3_AA_9_AA_4_AA_9_BB_8_DN_2_AA_9_AA_7_AA_9_AA_8_AA_9_AA_1_ADFA_1_1_APBIDDDMADFB_-1_0_AP_0_AFBMFC_-1_1_APBRAFAPBRFD_1_BRAPBRBRAFADFE_1_-1_BMAFBMADADFF_0_1_APBRAFBMADFG_0_-1_APFH_-1_-1_APEQAFBMADFIEU_4_DLED_-1_0_DSBQAF_-1_0_DSBQAF_1_1_BMAF_0_-1_BMAF_0_-1_BMAF_0_-1_BMAF_0_APBRAF_0_-1_BMA
122,113,113,10,489,0,-489,0,EY_9_AA_9_AA_1_BMAFAA_2_AA_9_AA_3_AA_9_AA_4_AA_9_AA_5_AA_9_AA_6_AA_9_AA_7_AA_9_AA_8_AA_9_AA_1_ADFA_1_1_APBIDDDMADFB_-1_0_-1_AP_0_AFBMFC_-1_1_APBRAFAPBRFD_1_BRAPADFE_1_-1_BMAFBMADADFF_0_DU_94_DADR_1_BMADAFBMADFG_0_-1_APBRAFADFH_-1_-1_APBRAFBMADFIEU_4_DLED_-1_0_DSBQAF_-1_0_DSBQAF_1_1_BMAF_0_-1_BMAF_0_-1_BMAF_0_-1_BMAF_0_APBRAF_0_-1_AA_9
123,59,59,13,493,595,102,0,EY_9_AA_9_AA_1_BMAFAA_2_AA_9_AA_3_AA_9_AA_4_AA_9_AA_5_AA_9_AA_6_AA_9_AA_7_AA_9_AA_8_AA_9_AA_1_ADFA_1_1_APBIDDDMADFB_-1_0_-1_AP_0_AFBMFC_-1_1_APBRAFAPBRFDBRAFAD_1_BRAPBRBRAFADFE_1_-1_BMAFBMADADFF_0_1_BMADAFBMADFG_0_-1_ADFH_-1_-1_APBRAFBMADFIEU_4_DLED_-1_0_DSBQAF_-1_0_DSBQAF_1_1_BMAF_0_-1_BMAF_0_-1_BMAF_0_-1_BMAF_0_APBRAF_0_-1_AA_9
124,115,115,15,494,0,-494,0,EY_9_AA_9_AA_1_AA_9_AA_2_AA_9_AA_3_AA_9_AA_4_AA_9_AA_5_AA_9_AA_6_AA_9_AA_7_AA_9_AA_8_AA_9_AA_1_ADFA_1_1_APBRAFBMADFB_-1_0_-1_BMAFBMADFC_-1_1_APBRAFBMADFD_2_BRAPBRAFBMADFE_1_AP_0_AFBM_-1_AP_0_AFBMADFF_1_APBRAF_0_1_APBRAFBMADFG_0_-1_APFH_-1_-1_APEQAFBMADFIEU_4_DLED_-1_0_DSBQAF_-1_0_DSBQAF_1_1_BMAF_0_-1_BMAF_0_-1_BMAF_0_-1_BMAF_0_APBRAF_0_-1_BMA
125,117,117,9,497,632,135,0,EY_9_AA_9_AA_1_AA_9_AA_2_AA_9_AA_3_AA_9_AA_4_AA_9_AA_5_AA_9_AA_6_AA_9_AAAA_9_AA_8_AA_9_AA_1_ADFA_1_1_APAFBMBMADFB_-1_0_-1_BMAFBMADFCAFBMADFD_1_BRAPBRBRAFADFE_1_-1_AP_0_FF_0_1_APBRAFBMADFG_0_-1_APBRADFH_1_3_APBRAFBMADFIEU_4_DLED_-1_0_DSBQAF_-1_0_DSBQAF_1_1_BMAF_0_-1_BMAF_0_-1_BMAF_0_-1_BMAF_0_APBR_0_-1_BMA
126,118,118,18,498,0,-498,0,EY_9_AA_9_AA_1_AA_9_AA_2_AA_9_AA_3_AA_9_AA_4_AA_9_AA_5_AA_9_AA_6_AA_9_AA_7_AA_9_AA_8_AAFA_1_1_APBRAFBMADFB_-1_0_-1_BMAFBMADFC_-1_1_APBRAFBMADFD_1_BRAFAFBMADFE_1_AP_0_AFBM_-1_AP_0_AFBMADFF_0_1_APBRAFBMADFG_0_-1_-1_FH_-1_-1_APEQAFBMADFIEU_4_DLED_-1_0_DSBQAF_-1_0_DSBQAF_1_1_BMAF_0_-1_BMAF_0_-1_BMAF_0_-1_BMAF_0_APBRAF_0_-1_BMA
127,16,16,4,499,538,39,0,EY_9_AA_9_AA_1_AA_9_AA_2_AA_9_AA_3_AA_9_AA_4_AA_9_AA_5_AA_9_AA_6_AA_9_AA_7_AA_9_AA_8_AA_9_AA_1_ADFA_1_1_APBRAFBMADFB_-1_0_-1_BMAFBMADFCAPBRAFBMADFD_1_BRAPBRAFBMADFE_1_BRAFBMAFBMADFF_0_1_APBRAFBMADFG_0_BRAFBMADFH_-1_-1_AP_-1_AP_0_ADFIEU_4_DLED_-1_0_DSBQAF_-1_0_DSBQAF_1_1_BMAF_0_-1_BMAF_0_-1_BMAF_0_-1_BMAF_0_APBRAF_0_-1_BMA
128,100,100,5,500,994,494,0,2
129,119,119,5,500,529,29,0,2
130,121,121,17,503,918,415,0,EY_9_AA_9_AA_1_AA_9_AA_2_AA_9_AA_3_AA_9_AA_4_AA_9_BB_8_DN_2_AA_9_AA_7_AA_9_AA_8_AA_9_AA_1_ADFA_1_1_APBIDDDMADFB_-1_0_AP_0_AFBMFC_-1_1_APBRAFAPBRFD_1_BRAPBRBRAFADFE_1_-1_BMAFBMADADFF_0_1_APBRAFBMADFG_0_-1_APFH_-1_-1_APEQAFBMADFIEU_4_DLED_-1_0_DSBQAF_-1_0_DSBQAF_1_1_BMAF_0_-1_BMAF_0_-1_BMAF_0_-1_BMAF_0_APBRAF_0_-1_BMA
131,124,124,16,509,941,432,0,EY_9_AA_9_AA_1_AA_9_AA_2_AA_9_AA_3_AA_9_AA_4_AA_9_AA_5_AA_9_AA_6_AA_9_AA_7_AA_9_AA_8_AA_9_AA_1_ADFA_1_1_APBRAFBMADFB_-1_0_-1_BMAFBMADFC_-1_1_APBRAFBMADFD_2_BRAPBRAFBMADFE_1_AP_0_AFBM_-1_AP_0_AFBMADFF_1_AP_0_1_APBRAFBMADFG_0_-1_APFH_-1_BQBU_-83_-1_APEQAFBMADFIEU_4_DLED_-1_0_DSBQAF_-1_0_DSBQAF_1_1_BMAF_0_-1_BMAF_0_-1_BMAF_0_-1_BMAF_0_APBRAF_0_-1_BMA
132,105,105,7,510,594,84,0,EY_9_AA_9_AA_1_AA_9_AA_2_AA_9_AA_3_AA_9_AA_4_AA_9_AA_5_AA_9_AA_6_AA_9_AAAA_9_AA_8_AA_9_AA_1_ADFA_1_1_APAFBMBMADFB_-1_0_-1_BMAFBMADFC_-1_1_APBRAFBMADFD_1_BRAPBRBRAFADFE_1_-1_AP_0_FF_0_1_APBRAFBMADFG_0_-1_APBRAFADFH_-1_-1_APBRAFBMADFIEU_4_DLED_-1_0_DSBQAF_-1_0_DSBQAF_1_1_BMAF_0_-1_BMAF_0_-1_BMAF_0_-1_BMAF_0_APBRAF_0_-1_BMA
133,129,129,6,515,559,44,0,2
134,128,128,6,515,560,45,0,EY_9_AA_9_AA_1_AA_9_AA_2_AA_9_AA_3_AA_9_AA_4_AA_9_AA_5_AA_9_AA_6_AA_9_AA_7_AA_9_AA_8_AA_9_AA_1_ADFA_1_1_APBRAFBMADFB_-1_0_APBRAFBMADFC_-1_1_APBRAFBMADFD_1_-1_APBRAFBMADFE_0_1_APBRAFBMADFF_0_-1_APBRAFBMADFG_-1_-1_APBRAFBMADFHEU_4_DLED_-1_0_DSBQAF_-1_0_DSBQAF_1_1_BMAF_0_-1_BMAF_0_-1_BMAF_0_-1_BMAF_0_-1_BMAF_0_-1_BMA
135,24,24,4,519,0,-519,0,3
136,110,110,14,520,0,-520,0,9
137,111,111,17,524,640,116,0,EY_9_AA_9_AA_1_AA_9_AA_2_AA_9_AA_3_AA_9_AA_4_AA_9_AA_5_AA_9_AA_6_AA_9_AA_7_AA_9_AA_8_AAFA_1_1_APBRAFBMADFB_-1_0_-1_BMAFBMADFC_-1_1_APBRAFBMADFD_1_BRAFBMAPBRAFBMADFE_1_AP_0_AFBM_-1_AP_0_AFBMADFF_0_1_APBRAFBMADFG_0_-1_-1_FH_-1_-1_APEQAFBMADFIEU_4_DLED_-1_0_DSBQAF_-1_0_DSBQAF_1_1_BMAF_0_-1_BMAF_0_-1_BMAF_0_-1_BMAF_0_APBRAF_0_-1_BMA
138,131,131,17,524,0,-524,0,EY_9_AA_9_AA_1_AA_9_AA_2_AA_9_AA_3_AA_9_AA_4_AA_9_AA_5_AA_9_AA_6_AA_9_AA_7_AA_9_AA_8_AA_9_AA_1_ADFA_1_1_APBRAFBMADFB_-1_0_-1_BMAFBMADFC_-1_1_APBRAFBMADFD_2_BRAPBRAFBMADFE_1_AP_0_AFBM_-1_AP_0_AFBMADFF_1_AP_0_1_APBRAFBMADALDJ_20_53_FGAPFH_-1_BQBU_-83_-1_APEQAFBMADFIEU_4_DLED_-1_0_DSBQAF_-1_0_DSBQAF_1_1_BMAF_0_-1_BMAF_0_-1_BMAF_0_-1_BMAF_0_APBRAF_0_-1_BMA
139,132,132,8,525,531,6,0,EY_9_AA_9_AA_1_AA_9_AA_2_AA_9_AA_3_AA_9_AA_4_AA_9_AA_5_AA_9_AA_6_AA_9_AAAA_9_AA_8_AA_9_AA_1_ADFA_1_1_BMBMADFB_-1_0_-1_BMAFBMADFC_-1_1_APBRAFBMADFD_1_BRAPBRBRAFADFE_1_-1_AP_0_FF_0_1_APBRAFBMADFG_0_-1_FH_-1_-1_APBRAFBMADFIEU_4_DLED_-1_0_DSBQAF_-1_0_DSBQAF_1_1_BMAF_0_-1_BMAF_0_-1_BMAF_0_-1_BMAF_0_APBRAFBMA
140,6,6,5,527,0,-527,0,15
141,83,83,3,528,0,-528,0,EY_9_AA_9_AA_1_AA_9_AA_2_AA_9_AA_3_AA_9_AA_4_AA_9_AA_5_AA_9_AA_6_AA_9_AA_7_AA_9_AA_8_AA_9_AA_1_ADFA_1_1_APBRAFBMADFB_-1_0_-1_BMAFBMADFC_-1_1_APBRBRAFBMAFBMADFD_1_BRAPBRAFBMADFE_1_-1_AP_0_AFBMADFF_0_1_APBRAFBMADFG_0_-1_APBRAFBMADFH_-1_-1_APBRAFBMADFIEU_4_DLED_-1_0_DSBQAF_-1_0_DSBQAF_1_1_BMAF_0_-1_BMAF_0_-1_BMAF_0_-1_BMAF_0_APBRAF_0_-1_BMA
142,133,133,7,530,661,131,0,EY_9_AA_9_AA_1_AA_9_AA_2_AA_9_AA_3_AA_9_AA_4_AA_9_AA_5_AA_9_AA_6_AA_9_AA_7_AA_9_AA_8_AA_9_AA_1_ADFA_1_1_APBRAFBMADFB_-48_-1_0_APBRAFBMADFC_-1_1_APBRAFBMADFD_1_0_APBRAFBMADFE_1_-1_APBRAFBMADFF_0_1_APBRFG_0_-1_APBRAFBMADFH_-1_-1_APBRAFBMADFIEU_4_DLED_-1_0_DSBQAF_-1_0_DSBQAF_1_1_BMAF_0_-1_BMAF_0_-1_BMAF_0_-1_BMAF_0_-1_BMAF_0_-1_BMA
143,135,135,5,534,563,29,0,5
144,18,18,10,535,0,-535,0,EY_9_AA_9_AA_1_AA_9_BW_4_AA_9_AA_3_AA_9_AA_4_AA_9_AA_5_AAAA_9_AA_7_9_AA_8_AA_9_AA_1_ADFAAD_1_APBRAFBM_1_FB_-1_0_APAFAFBMADFC_-1_1_APBRBMADADFD_1_0_APBRAFBCBIFE_1_-1_APBRADFF_0_1_APBRAFBMADFG_0_-1_APBRAFBMADFH_-1_-1_APBRAFBMADFIEU_4_DLED_-1_0_DSBQAF_-1_0_DSBQAF_1_1_BMAF_0_-1_BMAF_0_-1_BMAF_0_-1_BMAF_0_-1_BMA
145,136,136,15,535,0,-535,0,9
146,120,120,3,542,595,53,0,EY_9_AA_9_AA_1_AA_9_AA_2_AA_9_AA_3_AA_9_AA_4_AA_9_AA_5_AA_9_AAAA_7_AA_9_AA_8_AA_9_AA_1_ADFA_1_-36_BBDWEC_1_BEBOBEEOADFB_-1_0_APBRAFBMADFC_-1_1_APBRAFBMADFD_1_0_APBRAFBMADFE_1_-1_APBRAFBMADAFFF_0_1_APBRAFBMADFG_0_-1_APBRAFBMADFH_-1_-1_AP_33_-10_BRAFBMADFIEU_4_DLED_-1_0_DSBQAF_-1_0_DSBQAF_1_1_BMAF_0_-1_BMAF_0_-1_BMAF_0_-1_BMAF_0_-1_BMAF_0_-1_BMA
147,141,141,4,543,696,153,0,EY_9_AA_9_AA_1_AA_9_AA_9_AA_3_AA_9_AA_4_AA_9_AA_5_AA_9_AA_6_AA_9_AA_7_AA_9_AA_8_AA_9_AA_1_ADFA_1_1_APBRAFBMADFB_-1_0_-1_BMAFADFC_-1_1_APBRBRAFBMAFBMADFD_1_BRAPBRAFBMADFE_1_-1_AP_0_AFBMADFF_0_1_APBRAFBMADFG_0_-1_APBRAFBMADFH_-1_-1_APBRAFBMADFIEU_4_DLED_-1_0_DSBQAF_-1_0_DSBQAF_1_1_BMAF_0_-1_BMAF_0_-1_BMAF_0_-1_BMAF_0_APBRAF_0_-1_BMA
148,99,99,11,545,0,-545,0,EY_9_AA_9_AA_1_BMAFAA_2_AA_9_AA_3_AA_9_AA_4_AA_9_AA_5_AA_9_AA_6_AA_9_AA_7_AA_9_AA_8_AA_9_AA_1_ADFA_1_1_APBIDDDMADFB_-1_0_-1_AP_0_AFBMFC_-1_1_APBRAFAPBRFD_1_BRAPBRBRAFADFE_1_-1_BMAFBMADADFF_0_DU_94_DADR_1_BMADAFBMADFG_0_-1_APBRAFADFH_-1_-1_APBRAFBMADFIEU_4_DLED_-1_0_DSBQAF_-1_0_DSBQAF_1_1_BMAF_0_-1_BMAF_0_-1_BMAF_0_-1_BMAF_0_APBRAF_0_-1_AA_9
149,142,142,8,545,0,-545,0,EY_9_AA_9_AA_1_AA_9_AA_2_AA_9_AA_3_AA_9_AA_4_AA_9_AA_5_AA_9_AA_6_AA_9_AA_7_AA_9_AA_8_AA_9_AA_1_ADFA_1_1_APBRAFBMADFB_-48_-1_0_APBRAFBMADFC_-1_1_APBRAFBMADFD_1_0_APBRAFBMADFE_1_-1_APBRAFBMADFF_0_1_APBRFG_0_-1_APBRAFBMADFH_-1_-1_APBRAFBMADFIEU_4_DLED_-1_0_DSBQAF_-1_0_DSBQAF_1_1_BMAF_0_-1_BMAF_0_-1_BMAF_0_-1_BMAF_0_-1_BMAF_0_-1_BMA
150,84,84,14,549,625,76,0,EY_9_AA_9_AA_1_BMAFAA_2_AA_9_AA_3_AA_9_AA_4_AA_9_AA_5_AA_9_AA_6_AA_9_AA_7_AA_9_AA_8_AA_9_AA_1_ADFA_1_1_APBIDDDMADFB_-1_0_-1_BMADAFBMFC_-1_1_APBRAFAPBRFDBRAFAD_1_BRAPBRBRAFADFE_1_-1_BMAFAP_0_ADFF_0_1_BMEOAFBMADFG_0_-1_ADFH_-1_-1_APBRAFBMADFIEU_4_DLED_-1_0_DSBQAF_-1_0_DSBQAF_1_1_BMAF_0_-1_BMAF_0_-1_BMAF_0_-1_BMAF_0_APBRAF_0_-1_AA_9
151,123,123,14,549,0,-549,0,EY_9_AA_9_AA_1_BMAFAA_2_AA_9_AA_3_AA_9_AA_4_AA_9_AA_5_AA_9_AA_6_AA_9_AA_7_AA_9_AA_8_AA_9_AA_1_ADFA_1_1_APBIDDDMADFB_-1_0_-1_AP_0_AFBMFC_-1_1_APBRAFAPBRFDBRAFAD_1_BRAPBRBRAFADFE_1_-1_BMAFBMADADFF_0_1_BMADAFBMADFG_0_-1_ADFH_-1_-1_APBRAFBMADFIEU_4_DLED_-1_0_DSBQAF_-1_0_DSBQAF_1_1_BMAF_0_-1_BMAF_0_-1_BMAF_0_-1_BMAF_0_APBRAF_0_-1_AA_9
152,143,143,6,549,0,-549,0,5
153,145,145,16,550,898,348,0,EY_9_AA_9_AA_1_AA_9_AA_2_AA_9_AA_3_AA_9_AA_4_AA_9_AA_5_AA_9_AA_6_AA_9_AA_7_AA_9_AA_8_AA_9_AA_1_ADFA_1_1_APBRAFBMADFB_-1_0_-1_BMAFBMADFC_-1_1_APBRAFBMADFD_1_BRAPBRAFBMADFE_1_AP_0_AFBM_-1_AP_0_AFBMADFF_1_APBRAF_0_1_APBRAFBMADFG_0_-1_APFHEU_4_DLED_-1_0_DSBQAF_-1_0_DSBQAF_1_1_BMAF_0_-1_BMAF_0_-1_BMAF_0_-1_BMAF_0_AP_-1_BMA
154,25,25,7,551,879,328,0,EY_9_AA_9_AA_1_AA_9_AA_2_AA_9_AA_3_AA_9_AA_4_AA_9_AA_5_AA_9_AA_6_AA_9_AA_7_AA_9_AA_8_AA_9_AA_1_ADFA_1_1_APBRAFBMADFB_-1_0_-1_BMAFBMADFC_-1_1_APBRAFBMADFD_1_BRAPBRAFBMADFE_1_-1_AP_0_AFBMADFF_0_1_APBRAFBMADFG_0_-1_APFH_-1_-1_APEQAFBMADFIEU_4_DLED_-1_0_DSBQAF_-1_0_DSBQAF_1_1_BMAF_0_-1_BMAF_0_-1_BMAF_0_-1_BMAF_0_APBRAF_0_-1_BMA
155,128,128,6,556,851,295,0,EY_9_AA_9_AA_1_AA_9_AA_2_AA_9_AA_3_AA_9_AA_4_AA_9_AA_5_-1_BMAF_0_AA_9_AA_7_AA_9_AA_8_AA_9_AA_1_ADFA_1_1_APBRAFBMADFB_-1_0_APBRAFBMADFC_-1_1_APBRAFBMADFD_1_0_APBRAFBMADFE_1_-1_APBRAFBMADFF_0_1_APBRAFBMADFG_0_-1_APBRAFBMADFH_-1_-1_APBRAFBMADFIEU_4_DLED_-1_0_DSBQAF_-1_0_DSBQAF_1_1_BMAF_0_AA_9_AA_6_-1_BMAF_0_-1_BMAF_0_-1_BMAF_0_-1_BMA
156,146,146,4,557,579,22,0,EY_9_AA_9_AA_1_AA_9_AA_2_AA_9_AA_3_AA_9_AA_4_AA_9_AA_5_AA_9_AAAA_7_AA_9_AA_8_AA_9_AA_1_ADFA_1_-36_BBDWEC_1_BEBOBEEOADFB_-1_0_APBRAFBMADFC_-1_1_APBRAFBMADFD_1_0_APBRAFBMADFE_1_-1_APBRAFBMADAFFF_0_1_APBRAFBMADFG_0_-1_APBRAFBMADFH_-1_-1_AP_33_-10_BRAFBMADFIEU_4_DLED_-1_0_DSBQAF_-1_0_DSBQAF_1_1_BMAF_0_-1_BMAF_0_-1_BMAF_0_-1_BMAF_0_-1_BMAF_0_-1_BMA
157,53,53,9,560,898,338,0,EY_1_1_APBIDDDMADFA_-1_0_-1_AP_0_AFBMFB_-1_1_APBRAFAPBRFC_1_BRAPBRBRAFADFD_1_-1_BMAFBMADADFE_0_DU_94_DADR_1_BMADAFBMADFF_0_-1_APBRAFADFG_-1_-1_APBRAFBMADFHEU_4_DLED_-1_0_DSBQAF_-1_0_DSBQAF_1_1_BMAF_0_-1_BMAF_0_-1_BMAF_0_-1_BMAF_0_APBRAF_0_-1_AA_9
158,105,105,7,561,661,100,0,EY_9_AA_9_AA_1_AA_9_AA_2_AA_9_AA_3_AA_9_AA_4_AA_9_AA_5_AA_9_AA_6_AA_9_AAAA_9_AA_8_AA_9_AA_1_ADFA_1_1_APAFBMBMADFB_-1_0_-1_BMAFBMADFC_-1_1_APBRAFBMADFD_1_BRAPBRBRAFADFE_1_-1_AP_0_FF_0_1_APBRAFBMADFG_0_-1_APBRAFADFH_-1_-1_APBRAFBMADFIEU_4_DLED_-1_0_DSBQAF_-1_0_DSBQAF_1_1_BMAF_0_-1_BMAF_0_-1_BMAF_0_-1_BMAF_0_APBRAF_0_-1_BMA
159,103,154,8,561,697,136,51,EY_9_AA_9_AA_1_AA_9_AA_2_AA_9_AA_3_AA_9_AA_4_AA_9_AA_5_AA_9_AA_6_AA_9_AA_7_AA_9_AA_8_AA_9_AA_1_ADFA_1_1_APBRAFBMADFB_-1_0_-1_BMAFBMADFC_-1_1_APBRAFBMADFD_1_BRAPBRAFBMADFE_1_-1_AP_0_AFBMADFF_0_1_APBMADFG_0_-1_APFH_-1_-1_APBR_-1_0_DSFIEU_4_DLED_-1_0_DSBQAFAFBMADBQAF_1_1_BMAF_0_-1_BMAF_0_-1_BMAF_0_-1_BMAF_0_APBRAF_0_-1_BMA
160,91,91,15,564,0,-564,0,0
161,95,95,4,564,702,138,0,2
162,152,152,7,564,612,48,0,5
163,150,150,15,564,827,263,0,EY_9_AA_9_AA_1_BMAFAA_2_AA_9_AA_3_AA_9_AA_4_AA_9_AA_5_AA_9_AA_6_AA_9_AA_7_AA_9_AA_8_AA_9_AA_1_ADFA_1_1_APBIDDDMADFB_-1_0_-1_BMAFBMFC_-1_1_APBRAF_-10_DL_74_APBRFDBR_-16_AFAD_1_BRAPBRBRAFADFE_1_-1_BMAFAP_0_ADFF_0_1_BMEOAFBMADFG_0_-1_ADFHEU_4_DLED_-1_0_DSBQAF_-1_0_DSBQAF_1_1_BMAF_0_-1_BMAF_0_-1_BMAF_0_-1_BMAF_0_APBRAF_0_-1_AA_9
164,155,155,7,571,682,111,0,EY_9_AA_9_AA_1_AA_9_AA_2_AA_9_AA_3_AA_9_AA_4_AA_9_AA_5_-1_BMAF_0_AA_9_AA_7_AA_9_AA_8_AA_9_AA_1_ADFA_1_1_APBR_1_-1_ADFB_-1_0_APBRAFBMADFC_-1_1_APBRAFBMADFD_1_0_APBRAFBMADFEAFBMAPBRAFBMADFF_0_1_APBRAFBMADFG_0_-1_APBRAFBMADFH_-1_-1_APBRAFBMADFIEU_4_DLED_-1_0_DSBQAF_-1_0_DSBQAF_1_1_BMAF_0_AA_9_AA_6_-1_BMAF_0_-1_BMAF_0_-1_BMAF_0_-1_BMA
165,156,156,5,572,682,110,0,12
166,135,135,5,575,652,77,0,3
167,136,136,15,576,0,-576,0,9
168,59,59,13,579,650,71,0,EY_9_AA_9_AA_1_BMAFAA_2_AA_9_AA_3_AA_9_AA_4_AA_9_AA_5_AA_9_AA_6_AA_9_AA_7_AA_9_AA_8_AA_9_AA_1_ADFA_1_1_APBIDDDMADFB_-1_0_-1_AP_0_AFBMFC_-1_1_APBRAFAPBRFDBRAFAD_1_BRAPBRBRAFADFE_1_-1_BMAFBMADADFF_0_1_BMADAFBMADFG_0_-1_ADFH_-1_-1_APBRAFBMADFIEU_4_DLED_-1_0_DSBQAF_-1_0_DSBQAF_1_1_BMAF_0_-1_BMAF_0_-1_BMAF_0_-1_BMAF_0_APBRAF_0_-1_AA_9
169,100,100,5,579,741,162,0,2
170,162,162,8,579,624,45,0,5
171,140,140,6,583,738,155,0,15
172,28,28,8,587,653,66,0,EY_9_AA_9_AA_1_AA_9_AA_2_AA_9_AA_3_AA_9_AA_4_AA_9_AA_5_AA_9_AA_6_AA_9_AA_7_AA_9_AA_8_AA_9_AA_1_ADFA_1_1_APBRAFBMADFB_-1_0_-1_BMAFBMADFC_-1_1_ADFD_1_BRAPBRAFBMADFE_1_-1_APBMADFF_0_1_APBRAFBMADFG_0_-1_APFH_-1_-1_APEQAFBMADFIEU_4_DLED_-1_0_DSBQAF_-1_0_DSBQAF_1_1_BMAF_0_-1_BMAF_0_-1_BMAF_0_-1_BMAF_0_APBRAF_0_-1_BMA
173,144,144,11,587,0,-587,0,6
174,165,165,6,587,0,-587,0,12
175,69,168,14,589,612,23,99,EY_9_AA_9_AA_1_BMAFAA_2_AA_9_AA_3_AAAA_9_AA_5_AA_9_AA_6_AA_9_AA_7_AA_9_AA_8_AA_9_AA_1_ADFA_1_1_APBIDDDMADFB_-1_0_-1_AP_0_AFBMFC_-1_1_APBRAFAPBRFDBRAFAD_1_BRAPBRBRAFADFE_1_-1_BMAFBMADADFF_0_DU_94_DADR_1_BMADAFBMADFG_0_-1_ADFH_-1_-1_APBRAFBMADFIEU_4_DLED_-1_0_DSBQAF_-1_0_DSBQAF_1_1_BMAF_0_-1_BMAF_0_-1_BMAF_0_-1_BMAF_0_APBRAF_0_-1_AA_9
176,122,122,11,590,0,-590,0,EY_9_AA_9_AA_1_BMAFAA_2_AA_9_AA_3_AA_9_AA_4_AA_9_AA_5_AA_9_AA_6_AA_9_AA_7_AA_9_AA_8_AA_9_AA_1_ADFA_1_1_APBIDDDMADFB_-1_0_-1_AP_0_AFBMFC_-1_1_APBRAFAPBRFD_1_BRAPADFE_1_-1_ADFF_0_DU_94_DADR_1_BMADAFBMADFG_0_-1_APBRAFADFH_-1_-1_APBRAFBMADFIEU_4_DLED_-1_0_DSBQAF_-1_0_DSBQAF_1_1_BMAF_0_-1_BMAF_0_-1_BMAF_0_-1_BMAF_0_APBRAF_0_-1_AA_9
177,166,166,6,590,619,29,0,3
178,45,45,7,591,0,-591,0,EY_9_AA_9_AA_1_AA_9_AA_2_AA_9_AA_3_AA_9_AA_4_AA_9_AA_5_AA_9_AA_6_AA_9_AA_7_AA_9_AA_8_AA_9_AA_1_ADFA_1_1_APBRAFBMADFB_-1_0_-1_BMAFBMADFC_-1_1_APBRAPFD_1_AFBMADFE_1_-1_AP_0_AFBMADFF_0_1_APBRAFBMADFG_0_-1_ADBRAFBMADFH_-1_-1_APBRAFBMA
179,84,84,14,594,632,38,0,EY_9_AA_9_AA_1_BMAFAA_2_AA_9_AA_3_AA_9_AA_4_AA_9_AA_5_AA_9_AA_6_AA_9_AA_7_AA_9_AA_8_AA_9_AA_1_ADFA_1_1_APBIDDDMADFB_-1_0_-1_BMADAFBMFC_-1_1_APBRAFAPBRFDBRAFAD_1_BRAPBRBRAFADFE_1_-1_BMAFAP_0_ADFF_0_1_BMEOAFBMADFG_0_-1_ADFH_-1_-1_APBRAFBMADFIEU_4_DLED_-1_0_DSBQAF_-1_0_DSBQAF_1_1_BMAF_0_-1_BMAF_0_-1_BMAF_0_-1_BMAF_0_APBRAF_0_-1_AA_9
180,170,170,9,594,626,32,0,EY_9_AA_9_AA_1_AA_9_AABS_29_2_AA_9_AA_3_AA_9_AA_4_AA_9_AA_5_AA_9_AA_6_AA_9_AA_7_AA_9_AA_8_AA_9_AA_1_ADFA_1_1_APBRAFBRAFBMADFB_-1_0_-1_BMAFBMADFCEU_4_DLED_-1_0_DSBQAF_-1_0_DSBQAF_1_1_BMAF_0_-1_BMAF_0_-1_BMAF_0_-1_BMAF_0_APBRAF_0_-1_BMAFFD_1_BRAPBRAFBMADFE_1_-1_AP_0_AFBMADFF_0_1_APBRAFBMADFG_0_-1_APBRAFBMADFH_-1_-1_APBRAFBMADFIA
181,169,169,6,594,723,129,0,EY_9_AA_9_AA_1_AA_9_AA_2_AA_9_AA_3_AA_9_AA_4_AA_9_AA_5_AA_9_AA_6_AA_9_AA_7_AA_9_AA_8_AA_9_AA_1_ADFA_1_1_APBRAFBMADFB_-1_0_APBRAFBMADFC_-1_1_APBRAFBMADFD_1_0_APBRAFBMADFE_1_-1_APBRAFBMADFF_0_1_APBRAFBMADFG_0_-1_APBRAFBMADFH_-1_-1_APBR_-1_APBRAFBMADFIEU_4_DLED_-1_0_DSBQAF_-1_0_DSBQAF_1_1_BMAF_0_-1_BMAF_0_-1_BMAF_0_-1_BMAF_0_-1_BMAF_0_-1_BMA
182,171,171,7,598,700,102,0,15
183,174,174,7,602,643,41,0,12
184,173,173,12,602,709,107,0,6
185,172,172,9,602,696,94,0,EY_9_AA_9_AA_1_AA_9_AA_2_AA_9_AA_3_AA_9_AA_4_AA_9_AA_5_AA_9_AA_6_AA_9_AA_7_AA_9_AA_8_AA_9_AA_1_ADFA_1_1_APBRAFBMADFB_-1_0_-1_BMAFBMADFC_-1_1_ADFD_1_BRAPBRAFBMADFE_1_-1_APBMADFF_0_1_APBRAFBMADFG_0_-1_APFH_-1_-1_APEQAFBMADFIEU_4_DLED_-1_0_DSBQAF_-1_0_DSBQAF_1_1_BMAF_0_-1_BMAF_0_-1_BMAF_0_-1_BMAF_0_APBRAF_0_-1_BMA
186,66,66,12,605,0,-605,0,EY_9_AA_9_AA_1_BMAFAA_2_AA_9_AA_3_AA_9_AA_4_AA_9_AA_5_AA_9_AA_6_AA_9_AA_7_AA_9_AA_8_AA_9_AA_1_ADFA_1_1_APBIDDDMADFB_-1_0_-1_AP_0_AFBMFC_-1_1_APBRAFAPBRFD_1_BRAPBRBRAFADFE_1_-1_BMAFEXAJADFF_0_1_BMADAFBMADFG_0_-1_APBRAFADFH_-1_-1_APBRAFBMADFIEU_4_DLED_-1_0_DSBQAF_-1_0_DSBQAF_1_1_BMAF_0_-1_BMAF_0_-1_BMAF_0_-1_BMAF_0_APBRAF_0_-1_AA_9
187,152,152,7,605,785,180,0,5
188,150,150,15,605,898,293,0,EY_9_AA_9_AA_1_BMAFAA_2_AA_9_AA_3_AA_9_AA_4_AA_9_AA_5_AA_9_AA_6_AA_9_AA_7_AA_9_AA_8_AA_9_AA_1_ADFA_1_1_APBIDDDMADFB_-1_0_-1_BMADAFBMFC_-1_1_APBRAFAPBRFDBRAFAD_1_BRAPBRBRAFADFE_1_-1_BMAFAP_0_ADFF_0_1_BMEOAFBMADFG_0_-1_ADFH_-1_-1_APBRAFBMADFIEU_4_DLED_-1_0_DSBQAF_-1_0_DSBQAF_1_1_BMAF_0_-1_BMAF_0_-1_BMAF_0_-1_BMAF_0_APBRAF_0_-1_AA_9
189,177,177,7,605,0,-605,0,3
190,119,119,5,606,633,27,0,2
191,154,154,8,607,0,-607,0,16
192,91,91,15,609,741,132,0,0
193,37,37,5,610,685,75,0,3
194,182,182,8,613,0,-613,0,EY_9_AA_9_AA_1_AA_9_AA_2_AA_9_AA_3_AA_9_AA_4_AA_9_AA_5_AAAA_9_AA_7_AA_9_AA_8_AA_9_AA_1_ADFAEU_4_DLED_-1_0_DSBQAF_-1_0_DSBQAF_1_1_BMAF_0_-1_BMAF_0_-1_BMAF_0_-1_BMAF_0_-1_BMAF_0_-1_BMAFFB_-1_0_AP_-98_AFAFBMADFC_-1_1_APBRAFBMADFD_1_0_APBRAFBMADFE_1_ADFF_0_1_APBRAFBMADFG_0_-1_APBRAFBMADFH_-1_-1_APBRAFBMADFIAD_1_EQEXEXBM_1
195,185,185,10,617,0,-617,0,EY_9_AA_9_AA_1_AA_9_AA_2_AA_9_AA_3_AA_9_AA_4_AA_9_AA_5_AA_9_AA_6_AA_9_AA_7_AA_9_AA_8_AA_9_AA_1_ADFA_1_1_APBRAFBMADFB_-1_0_-1_BMAFBMADFC_-1_1_ADFD_1_BRAPBRAFBMADFE_1_-1_APBMADFF_0_1_APBRAFBMADFG_0_-1_APFH_-1_-1_APEQAFBMADFIEU_4_DLED_-1_0_DSBQAF_-1_0_DSBQAF_1_1_BMAF_0_-1_BMAF_0_-1_BMAF_0_-1_BMAF_0_APBRAF_0_-1_BMA
196,184,184,13,617,732,115,0,6
197,120,41,6,620,815,195,-79,EY_9_AA_9_AA_1_AA_9_AA_2_AA_9_AA_3_AA_9_AA_4_AA_9_AA_5_AA_9_AAAA_7_AA_9_AA_8_AA_9_AA_1_ADFA_1_1_APBRAFBMADFB_-1_0_-1_BMAFBMADFC_-1_1_APBRAFBMADFD_1_0_APBRAFBMADFE_1_-1_APBRAFBMADAFFF_0_1_APBRAFBMADFG_0_-1_APBRAFBMADFH_-1_-1_AP_33_-10_BRAFBMADFIEU_4_DLED_-1_0_DSBQAF_-1_0_DSBQAF_1_1_BMAF_0_-1_BMAF_0_-1_BMAF_0_-1_BMAF_0_APBRAF_0_-1_BMA
198,161,161,5,620,637,17,0,2
199,160,160,16,620,0,-620,0,EY_9_AA_9_AA_1_BMAFAA_2_AA_9_AA_3_AA_9_AA_4_AW_13_AC_5_AA_9_AA_6_AA_9_AA_7_AA_9_AA_8_AA_9_AA_1_ADFA_1_1_APBIDDDMADFB_-1_0_-1_BMADAFBMFCBRAFAD_1_BRAPBRBRAFADFD_-1_1_APBRAFAPBRFE_1_-1_BMAFAP_0_ADFF_0_1_BMAFBMADFG_0_-1_ADFH_-1_-1_APBRAFBMADFIEU_4_DLED_-1_0_DSBQAF_-1_0_DSBQAF_1_1_BMAF_0_-1_BMAF_0_-1_BMAF_0_-1_BMAF_0_APBRAF_0_-1_AA_9
200,188,188,16,620,668,48,0,EY_9_AA_9_AA_1_BMAFAA_2_AA_9_AA_3_AA_9_AA_4_AA_9_AA_5_AA_9_AA_6_AA_9_AA_7_AA_9_AA_8_AA_9_AA_1_ADFA_1_1_APBIDDDMADFB_-1_0_-1_BMADAFBMFC_-1_1_APBRAFAPBRFDBRAFAD_1_APBRBRAFADFE_1_-1_BMAFAP_0_ADFF_0_1_BMEOAFBMADFG_0_-1_ADFH_-1_-1_APBRAFBMADFI_4_DLED_-1_0_DSBQAF_-1_0_DSBQAF_1_1_BMAF_0_-1_BMAF_0_-1_BMAF_0_-1_BMAF_0_APBRAF_0_-1_AA_9
201,187,187,8,620,994,374,0,5
202,191,191,9,622,683,61,0,16
203,192,192,16,624,0,-624,0,EY_9_AA_9_AA_1_BMAFAA_2_AA_9_AA_3_AA_9_AA_4_AW_13_AC_5_AA_9_AA_6_AADTEJ_9_AA_7_AA_9_AA_8_AA_9_AA_1_ADFA_1_1_APBIDDDMADFB_-1_0_-1_BMADAFBMFCBRAFAD_1_BRAPBRBRAFADFD_-1_1_APBRAFAPBRFE_1_-1_BMAFAP_0_ADFF_0_1_BMEOAFBMADFG_0_-1_ADFH_-1_-1_APBRAFBMADFIEU_4_DLED_-1_0_DSBQAF_-1_0_DSBQAF_1_1_BMAF_0_-1_BMAF_0_-1_BMAF_0_-1_BMAF_0_APBRAF_0_-1_AA_9
204,193,193,6,625,630,5,0,3
205,159,195,11,627,657,30,36,EY_9_AA_9_AA_1_AA_9_AA_2_AA_9_AA_3_AA_9_AA_4_AA_9_AA_5_AA_9_AA_6_AA_9_AA_7_AA_9_AA_8_AA_9_AA_1_ADFA_1_92_-6_EJDD_1_APBRAFBMADFB_-1_0_-1_BMAFBMADFC_-1_1_ADFD_1_BRAPBRAFBMADFE_1_-1_AP_0_AFBMADFF_0_1_APBMADFG_0_-1_APFH_-1_-1_APBR_-1_0_DSFIEU_4_DLED_-1_0_DSBQAF_-1_0_DSBQAF_1_1_BMAF_0_-1_BMAF_0_-1_BMAF_0_-1_BMAF_0_APBRAF_0_-1_BMA
206,166,166,6,631,0,-631,0,3
207,141,141,4,635,647,12,0,EY_9_AA_9_AA_1_AA_9_AA_2_AA_9_AA_3_AA_9_AA_4_AA_9_AA_5_AA_9_AA_6_AA_9_AAAA_7_AA_9_AA_8_AA_9_AA_1_ADFA_1_1_APBRAFBMADFB_-1_0_-1_BMAFBMADFC_-1_1_APBRBRAFBMAFBMADFD_1_BRAPBRAFBMADFE_1_-1_AP_0_AFBMADFF_0_1_APBRAFBMADFG_0_-1_APBRAFBMADFH_-1_BMADFIEU_4_DLED_-1_0_DSBQAF_-1_0_DSBQAF_1_1_BMAF_0_-1_BMAF_0_-1_BMAF_0_-1_BMAF_0_APBRAF_0_-1_BMA
208,169,169,6,635,642,7,0,2
209,201,201,9,635,701,66,0,EY_9_AA_9_AA_1_AA_9_AABS_29_2_AA_9_AA_3_AA_9_AA_4_AA_9_AA_5_AA_9_AA_6_AA_9_AA_7_AA_9_AA_8_AA_9_AA_1_ADFA_1_1_APBRAFBMADFB_-1_0_-1_BMAFBMADFCADFD_1_BRAPBRAFBMADFE_5_-3_AP_0_AFBMADFF_0_1_APBRAFBMADFG_0_-1_APBRAFBMADFH_-1_-1_APBRAFBMADFIEU_4_DLED_-1_0_DSBQAF_-1_0_DSBQAF_1_1_BMAF_0_-1_BMAF_0_-1_BMAF_0_-1_BMAF_0_APBRAF_0_-1_BMA
210,198,198,6,635,756,121,0,2
211,171,171,7,639,0,-639,0,15
212,173,173,12,639,0,-639,0,6
213,203,203,17,639,0,-639,0,EY_9_AA_9_AA_1_BMAFAA_2_AA_9_AA_3_AA_9_AA_4_AW_13_AC_5_AA_9_AA_6_AADTEJ_9_AA_7_AA_9_AA_8_AA_9_AA_1_ADFA_1_1_APBIDDDMADFB_-1_0_-1_BMADAFBMFC_-1_1_APBRAFAPBRFD_1_-1_BMAFAP_0_ADFE_0_1_BMEOAFBMADFF_0_-1_ADFG_-1_-1_APBRAFBMADFHEU_4_DLED_-1_0_DSBQAF_-1_0_DSBQAF_1_1_BMAF_0_-1_BMAF_0_BB_-1_BMAF_0_-1_BMAF_0_APBRAF_0_-1_AA_9
214,52,52,9,641,693,52,0,EY_9_AA_9_AA_1_AA_9_AA_2_AA_9_AA_3_AA_9_AA_4_AA_9_AA_5_AA_9_AA_6_AA_9_AA_7_AA_9_AA_8_AA_9_AA_1_ADFA_1_1_APBRAFBMADFB_-1_0_-1_BMAFBMADFC_-1_1_APBRADFD_1_BRAPBRAFBMADFE_1_-1_AP_42_DBDZ_97_0_AFBMADFF_0_1_APBRAFBMADFG_0_-1_APBRAFBMADFH_-1_-1_APBRAFBMADFIEU_4_DLED_-1_0_DSBQAF_54_77_-1_0_DSBQAF_1_1_BMAF_0_-1_BMAF_0_-1_BMAF_0_-1_BMAF_0_APBRAF_0_-1_BMA
215,174,174,7,642,726,84,0,EY_9_AA_9_AA_1_AA_9_AA_2_AA_9_AA_3_AA_9_AA_4_AA_9_AA_5_AA_9_AAAA_7_AA_9_AA_8_AA_9_AA_1_ADFA_1_-36_BBDWEC_1_BEBOBEEOADFB_-1_0_APBRAFBMADFC_-1_1_APBRAFBMADFD_1_0_APBRAFBMADFE_1_-1_APBRAFBMADAFFF_0_1_APBRAFBMADFG_0_-1_APBRAFBMADFH_-1_-1_AP_33_-10_BMADFIEU_4_DLED_-1_0_DSBQAF_-1_0_DSBQ_1_1_BMAF_0_-1_BMAF_0_-1_BMAF_0_-1_BMAF_0_-1_BMAF_0_-1_BMA
216,205,205,12,642,691,49,0,EY_9_AA_9_AA_1_AA_9_AA_2_AA_9_AA_3_AA_9_AA_4_AA_9_AA_5_AA_9_AA_6_AA_9_AA_7_AA_9_AA_8_AA_9_AA_1_ADFA_1_92_-6_EJDD_1_AP_-6_BRAFBMADFB_-1_0_-1_BMAFBMADFC_1_4_AYFD_1_BRAPBRAFBMADFE_1_-1_AP_0_AFBMADFF_0_FG_0_-1_APFH_-1_-1_APBR_-1_0_DSFIEU_4_DLED_-1_0_DSBQAF_-1_0_DSBQAF_1_1_BMAF_0_-1_BMAF_0_-1_BMAF_0_-1_BMAF_0_APBRAF_0_-1_BMA
217,147,181,7,645,837,192,34,EY_9_AA_9_AA_1_AA_9_AA_9_AA_3_AA_9_AA_4_AA_9_AA_5_AA_9_AA_6_AA_9_AA_7_AA_9_AA_8_AA_9_AA_1_ADFA_1_1_APBRAFBMADFBEF_-7_ER_-1_0_APBRAFBMADFC_-1_1_APBRBRAFBMAFBMADFD_1_0_APBRAFBMAD_-59_13_FE_1_-1_APBRAFBMADAPBRAFFF_0_1_APBRAFBMADFG_0_-1_APBRAFBMADFH_-1_-1_APBR_-1_APBRAFBMADFIEU_4_DLED_-1_0_DSBQAF_-1_0_DSBQAF_1_1_BMAF_0_-1_BMAF_0_-1_BMAF_0_-1_BMAF_0_APBRAF_0_-1_BMA
218,148,148,12,646,811,165,0,EY_9_AA_9_AA_1_BMAFAA_2_AA_9_AA_3_AA_9_AA_4_AA_9_AA_5_AA_9_AA_6_AA_9_AA_7_AA_9_AA_8_AA_9_AA_1_ADFA_1_1_APBIDDDMADFB_-1_0_-1_AP_0_AFBMFC_-1_1_APBRAFAPBRFD_1_BRAPBRBRAFADFE_1_-1_BMAFBMADADFF_0_DU_94_DADR_1_BMADAFBMADFG_0_-1_APBRAFADFH_-1_-1_APBRAFBMADFIEU_4_DLED_-1_0_DSBQAF_-1_0_DSBQAF_1_1_BMAF_0_-1_BMAF_0_-1_BMAFBMAF_0_APBRAF_0_-1_AA_9
219,194,194,9,649,0,-649,0,EY_9_AA_9_AA_1_AA_9_AA_2_AA_9_AA_3_AA_9_AA_4_AA_9_AA_5_AAAA_9_AA_7_AA_9_AA_8_AA_9_AA_1_ADFA_-1_0_AP_-98_AFAFBMADFB_-1_1_APBRAFBMADFC_1_0_APBRAFBMADFD_1_ADFE_0_1_APBRAFBMADFF_0_-1_APBRAFBMADFG_-1_-1_APBRAFBMADFHAD_1_EQEXEXBM_1
220,91,91,15,650,741,91,0,0
221,209,209,10,650,708,58,0,EY_9_AA_9_AA_1_AA_9_AABS_29_2_AA_9_AA_3_AA_9_AA_4_AA_9_AA_5_AA_9_AA_6_AA_9_AA_7_AA_9_AA_8_AA_9_AA_1_ADFA_1_1_APBRAFBMADFBBRAFBMBMAFBMADFCEHFD_1_BRAP_-1_0_-1_ADFE_5_-3_AP_0_AFBMADFF_0_1_APBRAFBMADFG_0_-1_APBRAFBMADFH_-1_-1_BIBRAFBMADFIEU_4_DLED_-1_0_DSBQAF_-1_0_DSBQAF_1_1_BMAF_0_-1_BMAF_0_-1_BMAF_0_-1_BMAF_0_APBRAF_0_-1_BMA
222,72,72,10,653,862,209,0,1
223,182,182,8,654,694,40,0,15
224,212,212,13,654,761,107,0,6
225,211,211,8,654,743,89,0,15
226,73,56,7,655,802,147,-17,EY_9_AA_9_AA_1_AA_9_AA_2_AA_9_AA_3_AA_9_AA_4_AA_9_AA_5_AA_9_AA_6_AA_9_AA_7_AA_9_AA_8_AA_9_AA_1_ADFA_1_1_APBRAFBMADFB_-1_0_APBRAFBMADFC_-1_1_APBRADFD_1_BRAPBRAFBMADFE_1_-1_APBRAFBMADFF_0_1_APBRAFBMADFG_0_-1_APBRAFBMADFH_-1_-1_APBRAFBMADFIEU_4_DLED_-1_0_DSBQAF_-1_0_DSBQAF_1_1_BMAF_0_-1_BMAF_0_-1_BMAF_0_-1_BMAF_0_APBRAF_0_-1_BMA
227,216,216,13,657,767,110,0,EY_9_AA_9_AA_1_AA_9_AA_2_AA_9_AA_3_AA_9_AA_4_AA_9_AA_5_AA_9_AA_6_AA_9_AA_7_AA_9_AA_8_AA_9_AA_1_ADFA_1_92_-6_EJDD_1_AP_-6_BRAFBMADFB_-1_0_-1_BMAFBMADFC_1_4_AYFD_1_BRAPBRAFBMADFE_1_-1_AP_0_AFBMADFF_0_FG_0_-1_APFH_-1_-1_APBR_-1_0_DSFIEU_6_DLED_-4_-2_DSBQAF_-4_-2_DSBQAF_4_-3_BMAF_2_1_BMAF_-1_2_BMAF_3_3_BMAF_4_APBRAF_2_-5_BMA
228,214,214,10,658,837,179,0,EY_9_AA_9_AA_1_AA_9_AA_2_AA_9_AA_3_AA_9_AA_4_AA_9_AA_5_AA_9_AA_6_AA_9_AA_7_AA_9_AA_8_AA_9_AA_1_ADFA_1_1_APBRAFBMADFB_-1_0_-1_BMAFBMADFC_-1_1_APBRADFD_1_BRAPBRAFBMADFE_1_-1_AP_42_DBDZ_97_0_AFBMADFF_0_1_APBRAFBMADFG_0_-1_APBRAFBMADFH_-1_-1_APBRAFBMADFIEU_4_DLED_-1_0_DSBQAF_54_77_-1_0_DSBQAF_1_1_BMAF_0_-1_BMAF_0_-1_BMAF_0_-1_BMAF_0_APBRAF_0_-1_BMA
229,187,187,8,661,0,-661,0,5
230,160,160,16,665,695,30,0,0
231,192,192,16,665,756,91,0,0
232,220,220,16,665,842,177,0,0
233,222,222,11,668,925,257,0,EY_9_AA_9_AA_1_AA_9_AA_2_AA_9_AA_3_AA_9_AA_4_AA_9_AA_6_AA_9_AA_7_AA_9_AA_8_AA_9_AA_1_ADFA_1_1_APBRAFBMADFB_-1_0_-1_BMAFBMADFC_-1_1_APBRAFBMADFD_1_AP_0_AFBM_-1_AP_0_AFBMADFE_0_1_APBRAFBMADFF_0_-1_APFG_-1_-1_APEQAFBMADFHEU_4_DLED_-1_0_DSBQAF_-1_0_DSBQAF_1_1_BMAF_0_-1_BMAF_0_-1_BMAF_0_-1_BMAF_0_APBRAF_0_-1_BMA
234,196,196,14,669,0,-669,0,EY_9_AA_9_AA_1_AA_9_BW_4_AA_9_AA_3_AA_9_AA_4_AA_9_AA_5_AAAA_9_AA_7_9_AA_8_AA_9_AA_1_ADFAAD_1_APBRAFBM_1_FB_-1_0_APAFAFBMADFC_-1_1_APBRBMADADFD_1_0_APBRAFBCBIFE_1_-1_APBRADFF_0_1_APBRAFBMADFG_0_-1_APBRAFBMBMADFH_-1_-1_ECAPBRAFADFIEU_4_DLED_-1_0_DSBQAF_-1_0_DSBQAF_1_1_BMAF_0_-1_BMAF_0_-1_BMAF_0_-1_BMAF_0_-1_BMA
235,224,224,14,669,0,-669,0,EY_9_AA_9_AA_1_AA_9_BW_4_AA_9_AA_3_AA_9_AA_4_AA_9_AA_5_AAAA_9_AA_7_9_AA_8_AA_9_AA_1_ADFAAD_1_APBRAFBM_1_FB_-1_-1_0_AFBMADFC_-1_1_APBRBMADADFD_1_0_APBRAFBCBIFE_1_-1_APBRADFF_0_1_APBRAFBMBJEWBHBVADFG_0_-1_ECAPBRAFBMADFH_-1_-1_APBRAFBMADFIEU_4_DLED_-1_0_DSBQAF_-1_0_DSBQAF_1_1_BMAF_0_-1_BMAF_0_-1_BMAF_0_-1_BMAF_0_-1_BMA
236,223,223,9,669,0,-669,0,EY_9_AA_9_AA_1_AA_9_AA_2_AA_9_AA_3_AA_9_AA_4_AA_9_AA_5_AAAA_9_AA_7_AA_9_AA_8_AA_9_AA_1_ADFAAD_1_EQEXEXBM_1_FB_-1_0_APAFAFBMADFC_-1_1_APBRAFBMADFD_1_0_APBRAFBMADFE_1_-1_APBRADFF_0_1_APBRAFBMADFG_0_-1_APBRAFBMADFH_-1_-1_APBRAFBMA
237,227,227,14,672,837,165,0,EY_9_AA_9_AA_1_AA_9_AA_2_AA_9_AA_3_AA_9_AA_4_AA_9_AA_5_AA_9_AA_6_AA_9_AA_7_AA_9_AA_8_AA_9_AA_1_ADFA_1_92_-6_EJDD_1_AP_-6_BRAFBMADFB_-1_0_-1_BMAFBMADFC_1_4_AYFD_1_BRAPBRAFBMADFE_1_-1_AP_0_AFBMADFF_0_FG_0_-1_APFH_-1_-1_APBR_-1_0_DSFIEU_6_DLED_-4_-2_DSBQAF_-4_-2_DSBQAF_4_-3_BMAF_2_1_BMAF_-1_2_BQBMAF_3_3_BMAF_4_APBRAF_2_-5_BMA
238,51,51,6,673,746,73,0,EY_9_AA_9_AA_1_AA_9_AA_2_AA_9_AA_3_AA_9_AA_4_AA_9_AA_5_AA_9_AA_6_AA_9_AA_7_AA_9_AA_8_AA_9_AA_1_ADFA_1_1_APBRAFBMADFB_-1_0_-1_BMAFBMADFC_-1_1_APBRADFD_1_BRAPBRAFBMADFE_1_-1_AP_0_AFBMADFF_0_1_APBRAFBMFG_0_-1_APBRAFBMADFH_-1_-1_APBRAFBMADFIEU_4_DLED_-1_0_DSBQAF_-1_0_DSBQAF_1_1_BMAF_0_-1_BMAF_0_-1_BMAF_0_-1_BMAF_0_APBRAF_0_-1_BMA
239,195,195,11,673,712,39,0,EY_9_AA_9_AA_1_AA_9_AA_2_AA_9_AA_3_AA_9_AA_4_AA_9_AA_5_AA_9_AA_6_AA_9_AA_7_AA_9_AA_8_AA_9_AA_1_ADFA_1_1_APBRAFBMADFB_-1_1_ADFC_1_BRAPBRAFBMADFD_0_1_APBRAFBMADFE_0_-1_APFF_-1_-1_APEQAFBMADFGEU_4_DLED_-1_0_DSBQAF_-1_0_DSBQAF_1_1_BMAF_0_-1_BMAF_0_-1_BMAF_0_-1_BMAF_0_APBRAF_0_-1_BMA
240,199,203,17,675,807,132,4,EY_9_AA_9_AA_1_BMAFAA_2_AA_9_AA_3_AA_9_AA_4_AW_13_AC_5_AA_9_AA_6_AADTEJ_9_AA_7_AA_9_AA_8_AA_9_AA_1_ADFA_1_1_APBIDDDMADFB_-1_0_-1_BMADAFBMFCBRAFAD_1_BRAPBRBRAFADFD_-1_1_APBRAFAPBRFE_1_-1_BMAFAP_0_ADFF_0_1_BMAFBMADFG_0_-1_ADFH_-1_-1_APBRAFBMADFIEU_4_DLED_-1_0_DSBQAF_-1_0_DSBQAF_1_1_BMAF_0_-1_BMAF_0_-1_BMAF_0_-1_BMAF_0_APBRAF_0_-1_AA_9
241,228,228,11,675,0,-675,0,EY_9_AA_9_AA_1_AA_9_AA_2_AA_9_AA_3_AA_9_AA_4_AA_9_AA_5_AA_9_AA_6_AA_9_AA_7_AA_9_AA_8_AA_9_AA_1_ADFA_1_1_APBRAFBMADFB_-1_0_-1_BMAFBMADFC_-1_1_APBRADFD_1_BRAPBRAFBMADFE_1_-1_AP_42_DBDZ_97_0_AFBMADFF_0_1_APBRAFBMADFG_0_-1_APBRAFBMADFH_-1_-1_APBRAFBMADFIEU_4_DLED_-1_0_DSBQAF_54_77_-1_0_DSBQAF_1_1_BMAF_0_-1_BMAFAF_0_-1_BMAF_0_APBRAF_0_-1_BMA
242,201,201,9,676,787,111,0,EY_9_AA_9_AA_1_AA_9_AABS_29_2_AA_9_AA_3_AA_9_AA_4_AA_9_AA_5_AA_9_AA_6_AA_9_AA_7_AA_9_AA_8_AA_9_AA_1_ADFA_1_1_APBRAFBMADFB_-1_0_-1_BMAFBMADFCADFD_1_BRAPBRAFBMADFE_0_1_APBRAFBMADFF_0_-1_APBRAFBMADFG_-1_-1_APBRAFBMADFHEU_4_DLED_-1_0_DSBQAF_-1_0_DSBQAF_1_1_BMAF_0_-1_BMAF_0_-1_BMAF_0_-1_BMAF_0_APBRAF_0_-1_BMA
243,197,197,7,676,739,63,0,14
244,229,229,9,676,686,10,0,EY_9_AA_9_AA_1_AA_9_AABS_29_64_-8_2_AA_9_AA_3_AA_9_AA_4_AA_9_AA_5_AA_9_AA_6_AA_9_AA_7_AA_9_AA_8_AA_9_AA_1_ADFA_1_1_APBRAFBMADFB_-1_0_-1_BMAFADFCADFD_1_BRAPBRAFBMADFE_1_-1_AP_0_AFBMADFF_0_1_APBRAFBMADFG_0_-1_APBRAFBMADFH_-1_-1_APBRAFBMADFIEU_4_DLED_-1_0_DSBQAF_-1_0_DSBQAF_1_1_BMAF_0_-1_BMAF_0_-1_BMAF_0_-1_BMAF_0_APBRAF_0_-1_BMA
245,232,232,17,680,898,218,0,0
246,231,231,17,680,852,172,0,0
247,165,165,6,681,855,174,0,EY_9_AA_9_AA_1_AA_9_AA_2_AA_9_AA_3_AA_9_AA_4_AA_9_AA_5_AA_9_AAAA_7_AA_9_AA_8_AA_9_AA_1_ADFA_1_-36_BBDWEC_1_BEBOBEEOADFB_-1_0_APBRAFBMADFC_1_0_APBRAFBMADFD_1_-1_APBRAFBMADAFFEAFBMADFF_-1_-1_AP_33_-10_BRAFBMADFGEU_4_DLED_-1_0_DSBQAF_-1_0_DSBQ_1_1_BMAF_0_-1_BMAF_0_-1_BMAF_0_-1_BMAF_0_-1_BMAF_0_-1_BMA
248,234,234,15,684,0,-684,0,EY_9_AA_9_AA_1_AA_9_BW_4_AA_9_AA_3_AA_9_AA_4_AA_9_AA_5_AAAA_9_AA_7_9_AA_8_AA_9_AA_1_ADFAAD_1_APBRAFBM_1_FB_-1_0_APAFAFBMADFC_-1_1_APBRBMADADFD_1_0_APBRAFBCBIFE_1_-1_APBRADFF_0_1_APBRAFBMADFG_0_-1_APBRAFBMBMADFH_-1_-1_ECAPBRAFADFIEU_4_DLED_-1_0_DSBQAF_-1_0_DSBQAF_1_1_BMAF_0_-1_BMAF_0_-1_BMAF_0_-1_BMAF_0_-1_BMA
249,149,149,9,687,813,126,0,EY_9_AA_9_AA_1_AA_9_AA_2_AA_9_AA_3_AA_9_AA_4_AA_9_AA_5_AA_9_AA_6_AA_9_AA_7_AA_9_AA_8_AA_9_AA_1_ADFA_1_1_APBRAFBMADFB_-48_-1_0_APBRAFBMADFC_-1_1_APBRAFBMADFD_1_0_APBRAFBMADFE_1_-1_APBRAFBMADFF_0_1_APBRFG_0_-1_APBRAFBMADFH_-1_-1_APBRAFBMADFIEU_4_DLED_-1_0_DSBQAF_-1_0_DSBQAF_1_1_BMAF_0_-1_BMAF_0_-1_BMAF_0_-1_BMAF_0_-1_BMAF_0_-1_BMA
250,206,206,7,687,0,-687,0,EY_9_AA_9_AA_1_AA_9_AA_2_AA_9_AA_3_AA_9_AA_4_AA_9_AA_5_AA_9_AA_6_AA_9_AA_7_AA_9_AA_8_AA_9_AA_1_ADFA_1_1_APBRAFBMADFB_-1_0_-1_BMAFBMADFC_-1_1_APBRADFD_1_BRAPBRAFBMADFE_1_-1_AP_0_AFBMADFF_0_BMADFG_0_-1_APBRAFBMADFH_-1_-1_APBRAFBMADFIEU_4_DLED_-1_0_DSBQAF_-1_0_DSBQAF_1_1_BMAF_0_-1_BMAF_0_-1_BMAF_0_-1_BMAF_0_APBRAF_0_-1_BMA
251,240,240,18,690,0,-690,0,EY_9_AA_9_AA_1_BMAFAA_2_AA_9_AA_3_AA_9_AA_4_AW_13_AC_5_AA_9_AA_6_AADTEJ_9_AA_7_AA_9_AA_8_AA_9_AA_1_ADFA_1_1_APBIDDDMADFB_-1_0_-1_BMADAFBMFCBRAFAD_1_BRAPBRBRAFADFD_-1_1_APBRAFAPBRFE_1_-1_BMAFAP_0_ADFF_0_1_BMAFBMADFG_0_0_ADFH_-1_-1_APBRAFBMADFIEU_4_DLED_-1_0_DSBQAF_-1_0_DSBQAF_1_1_BMAF_0_-1_BMAF_0_-1_BMAF_0_-1_BMAF_0_APBRAF_0_-1_AA_9
252,210,210,7,691,714,23,0,2
253,212,212,13,691,777,86,0,6
254,243,243,8,691,724,33,0,14
255,52,52,9,694,876,182,0,EY_9_AA_9_AA_1_AA_9_AA_2_AA_9_AA_3_AA_9_AA_4_AA_9_AA_5_AA_9_AA_6_AA_9_AA_7_AA_9_AA_8_AA_9_AA_1_ADFA_1_1_APBRAFBMADFB_-1_0_-1_BMAFBMADFC_-1_1_APBRADFD_1_BRAPBRAFBMADFE_-1_APBR_0_AFBMADFF_0_1_APBRAFBMADFG_0_-1_APBRAFBMADFH_-1_1_-1_APAFBMADFIEU_4_DLED_-1_0_DSBQAF_54_77_-1_0_DSBQAF_1_1_BMAF_0_-1_BMAF_0_-1_BMAF_0_-1_BMAF_0_APBRAF_0_-1_BMA
256,91,91,15,695,0,-695,0,EY_9_AA_9_AA_1_BMAFAA_2_AA_9_AA_3_AA_9_AA_4_AW_13_AC_5_AA_9_AA_6_AAET_9_AA_7_AA_9_AA_8_AA_9_AA_1_ADFA_1_1_APBIDDDMADFB_-1_0_-1_BMADAFBMFCBRAPBRBRAFADFD_-1_1_APBRAFAPBRFEBMBK_-38_DV_1_-1_BMAFAP_0_ADFF_0_1_BMEOAFBMADFG_0_-1_ADFH_-1_-1_APBRAFBMADFIEU_4_DLED_-1_0_DSBQAF_-1_0_DSBQAF_1_1_BMAF_0_-1_BMAF_0_-1_BMAF_0_-1_BMAF_0_APBRAF_0_-1_AA_9
257,217,217,8,701,0,-701,0,EY_9_AA_9_AA_1_AA_9_AA_9_AA_3_AA_9_AA_4_AA_9_AA_5_AA_9_AA_6_AA_9_AA_7_AA_9_AA_8_AA_9_AA_1_ADFABRAFBMAD_1_1_APBRAFBMADFBEF_-7_ER_-1_0_APBRAFBMADFC_-1_1_APBRBRAFBMAFBMADFD_1_0_APBRAFBMAD_-59_13_FE_1_-1_APBRAFBMADAPBRAFFF_0_1_APBRAFBMADFG_0_-1_ADFH_-1_-1_APBR_-1_APBRAFBMADFIEU_4_DLED_-1_0_DSBQAF_-1_0_DSBQAF_1_1_BMAF_0_-1_BMAF_0_-1_BMAF_0_-1_BMAF_0_APBRAF_0_-1_BMA
258,250,250,8,702,0,-702,0,EY_9_AA_9_AA_1_AA_9_AA_2_AA_9_AA_3_AA_9_AA_4_AA_9_AA_5_AA_9_AA_6_AA_9_AA_7_AA_9_AA_8_AA_9_AA_1_ADFA_1_1_APBRAFBMADFB_-1_0_-1_BMAFBMADFC_-1_1_APBRADFD_1_BRAPBRAFBMADFE_1_-1_AP_0_AFBMADFF_0_BMADFG_0_-1_APBRAFBMADFH_-1_-1_APBRAFBMADFIEU_4_DLED_-1_0_DSBQAF_-1_0_DSBQAF_1_1_BMAF_0_-1_BMAF_0_-1_BMAF_0_-1_BMAF_0_APBRAF_0_-1_BMA
259,160,160,16,706,830,124,0,0
260,186,186,13,706,0,-706,0,EY_9_AA_9_AA_1_BMAFAA_2_AA_9_AA_3_AA_9_AA_4_AA_9_AA_5_AA_9_AA_6_AA_9_AA_7_AA_9_AA_8_AA_9_AA_1_ADFA_1_1_APBIDDDMADFB_-1_0_-1_AP_0_AFBMFC_-1_1_APBRAFAPBRFD_1_BRAPBRBRAFADFE_1_-1_BMAFEXAJADFF_0_1_BMADAFBMADFG_0_-1_APBRAFADFH_-1_-1_APBRAFBMADFIEU_4_DLED_-1_0_DSBQAF_-1_0_DSBQAF_1_1_BMAF_0_-1_BMAF_0_-1_BMAF_0_-1_BMAF_0_APBRAF_0_-1_AA_9
261,254,254,9,706,711,5,0,EY_9_AA_9_AA_1_AA_9_AA_2_AA_9_AA_3_AA_9_AA_4_AA_9_AA_5_AA_9_AAAA_7_AA_9_AA_8_AA_9_AA_1_ADFA_1_1_APBRAFBMADFB_-1_0_-1_BMAFBMADFC_-1_1_APBRAFBMADFD_1_0_APBRAFBMADFE_1_-1_APBRAFBMADAFFF_0_1_APDSAKBMADFG_0_BRAFADFH_-1_-1_AP_33_-10_BRAFBMADFIEU_4_DLED_-1_0_DSBQAF_-1_0_DSBQAF_1_1_BMAF_0_-1_BMAF_0_-1_BMAF_0_-1_BMAF_0_APBRAF_0_-1_BMA
262,253,253,14,706,760,54,0,6
263,193,152,7,707,0,-707,-41,EY_9_AA_9_AA_1_AA_9_AABS_29_2_AA_9_AA_3_AA_9_AA_4_AA_9_AA_5_AA_9_AA_6_AA_9_AA_7_AA_9_AA_8_AA_9_AA_1_ADFA_1_1_APBRAFBMADFB_-1_0_-1_BMAFBMADFC_-1_1_APBRADFD_1_BRAPBRAFBMADFE_1_-1_AP_0_AFBMADFF_0_1_APBRAFBMADFG_0_-1_APBRAFBMADFH_-1_-1_APBRAFBMADFIEU_4_DLED_-1_0_DSBQAF_-1_0_DSBQAF_1_1_BMAF_0_-1_BMAF_0_-1_BMAF_0_-1_BMAF_0_APBRAF_0_-1_BMA
264,206,189,8,707,900,193,-17,EY_9_AA_9_AA_1_AA_9_AA_2_AA_9_AA_3_AA_9_AA_4_AA_9_AA_5_AA_9_AA_6_AA_9_AA_7_AA_9_AA_8_AA_9_AA_1_ADFA_1_1_APBRAFBMADFB_-1_0_BRAFBMADADFC_-1_1_APBRADFD_1_BRAPBRAFBMADFE_1_-1_AP_0_AFBMADFF_0_1_APBRAFBMADFG_0_-1_AP_-1_BMAFBMFH_-1_-1_APBRAFBMADFIEU_4_DLED_-1_0_DSBQAF_-1_0_DSBQAF_1_1_BMAF_0_-1_BMAF_0_-1_BMAF_0_-1_BMAF_0_APBRAF_0_-1_BMA
265,256,256,16,710,755,45,0,EY_9_AA_9_AA_1_BMAFAA_2_AA_9_AA_3_AA_9_AA_4_AW_13_AC_5_AA_9_AA_6_AAET_9_AA_7_AA_9_AA_8_AA_9_AA_1_ADFA_1_1_APBIDDDMADFB_-1_0_-1_BMADAFBMFCBRAPBRBRAFADFD_-1_1_APBRAFAPBRFEBMBK_-38_DV_1_-1_BMAFAP_0_ADFF_0_1_BMEOAFBMADFG_0_-1_ADFH_-1_-1_APBRAFBMADFIEU_4_DLED_-1_0_DSBQAF_-1_0_DSBQAF_1_1_BMAF_0_-1_BMAF_0_-1_BMAF_0_-1_BMAF_0_APBRAF_0_-1_AA_9
266,226,226,8,711,733,22,0,EY_9_AA_9_AA_1_AA_9_AA_2_AA_9_AA_3_AA_9_AA_4_AA_9_AA_5_AA_9_AA_6_AA_9_AA_7_AA_9_AA_8_AA_9_AA_1_ADFA_1_1_APBRAFBMADFB_-1_0_APBRAFBMADFC_-1_1_APBRADFD_1_BRAPBRAFBMADFE_1_-1_APBRAFBMADFF_0_1_APBRAFBMADFG_0_-1_APBRAFBMADFH_-1_-1_APBRAFBMADFIEU_4_DLED_-1_0_DSBQAF_-1_0_DSBQAF_1_1_BMAF_0_-1_BMAF_0_-1_BMAF_0_-1_BMAF_0_APBRAF_0_-1_BMA
267,255,255,10,711,765,54,0,EY_9_AA_9_AA_1_AA_9_AA_2_AA_9_AA_3_AA_9_AA_4_AA_9_AA_5_AA_9_AA_6_AA_9_AA_7_AA_9_AA_8_AA_9_AA_1_ADFA_1_1_APBRAFBMADFB_-1_0_-1_BMAFBMADFC_-1_APBRAFADFD_1_BRAPBRAFBMADFE_-1_APBR_0_AFBMADFF_0_1_APBRAFBMADFG_0_-1_1_APBRBMADFH_-1_1_-1_APAFBMADFIEU_4_DLED_-1_0_DSBQAF_54_77_-1_0_DSBQAF_1_1_BMAF_0_-1_BMAF_0_-1_BMAF_0_-1_BMAF_0_APBRAF_0_-1_BMA
268,227,227,14,713,893,180,0,EY_9_AA_9_AA_1_AA_9_AA_2_AA_9_AA_3_AA_9_AA_4_AA_9_AA_5_AA_9_AA_6_AA_9_AA_7_AA_9_AA_8_AA_9_AA_1_ADFA_1_92_-6_EJDD_1_AP_-6_BRAFBMADFB_-1_0_-1_BMAFBMADFC_1_4_AYFD_1_BRAPBRAFBMADFE_1_-1_AP_0_AFBMADFF_0_FG_0_-1_APFH_-1_-1_APBR_-1_0_DSFIEU_6_DLED_-4_-2_DSBQAF_-4_-2_DSBQAF_4_-3_BMAF_2_1_BMAF_-1_2_BMAF_3_3_BMAF_4_APBRAF_2_-5_BMA
269,257,257,9,716,876,160,0,EY_9_AA_9_AA_1_AA_9_AA_9_AA_3_AA_9_AA_4_AA_9_AA_5_AA_9_AA_6_AA_9_AA_7_AA_9_AA_8_AA_9_AA_1_ADFABRAFBMAD_1_1_APBRAFBMADFBEF_-7_ER_-1_0_APBRAFBMADFC_1_0_APBRAFBMAD_-59_13_FD_1_-1_APBRAFBMADAPBRAFFE_0_1_APBRAFBMADFF_0_-1_ADFG_-1_-1_APBR_-1_APBRAFBMADFHEU_4_DLED_-1_0_DSBQAF_-1_0_DSBQAF_1_1_BMAF_0_-1_BMAF_0_-1_BMAF_0_-1_BMAF_0_APBRAF_0_-1_BMA
270,228,228,11,718,945,227,0,EY_9_AA_9_AA_1_AA_9_AA_2_AA_9_AA_3_AA_9_AA_4_AA_9_AA_5_AA_9_AA_6_AA_9_AA_7_AA_9_AA_8_AA_9_AA_1_ADFA_1_1_APBRAFBMADFB_-1_0_-1_BMAFBMADFC_-1_1_APBRADFD_1_BRAPBRAFBMADFE_1_-1_AP_42_DBDZ_97_0_AFBMADFF_0_1_APBRAFBMADFG_0_-1_APBRAFBMADFH_-1_-1_APBRAFBMADFIEU_4_DLED_-1_0_DSBQAF_54_77_-1_0_DSBQAF_1_1_BMAF_0_-1_BMAF_0_-1_BMAF_0_-1_BMAF_0_APBRAF_0_-1_BMA
271,249,155,7,720,726,6,-94,EY_9_AA_9_AA_1_AA_9_AA_2_AA_9_AA_3_AA_9_AA_4_AA_9_AA_5_-1_BMAF_0_AA_9_AA_7_AA_9_AA_8_AA_9_AA_1_ADFA_1_1_APBRAFBMADFB_-48_-1_0_APBRAFBMADFC_-1_AFBMADAFBMADFD_1_0_APBRAFBMADFE_1_-1_APBRAFBMADFF_0_1_APBR_1_APBRFG_0_-1_APBRAFBMADFH_-1_-1_APBRAFBMADFIEU_4_DLED_-1_0_DSBQAF_-1_0_DSBQAF_1_1_BMAF_0_-1_BMAF_0_-1_BMAF_0_-1_BMAF_0_-1_BMAF_0_-1_BMA
272,199,199,17,721,0,-721,0,EY_1_1_APBIDMADFA_-1_0_-1_BMADAFBMFBBRAFAD_1_BRAPBRBRAFADFC_-1_1_APBRAFAPBRFD_1_-1_BMAFAP_0_ADFE_0_1_BMAFBMADFF_0_-1_ADFG_-1_-1_APBRAFBMADFHEU_4_DLED_-1_0_DSBQAF_-1_0_DSBQAF_1_1_BMAF_0_-1_BMAF_0_-1_BMAF_0_-1_BMAF_0_APBRAF_0_-1_AA_9
273,259,259,17,721,0,-721,0,EY_9_AA_9_AA_1_BMAFAA_2_AA_9_AA_3_AA_9_AA_4_AW_13_AC_5_AA_9_AA_6_AA_9_AA_7_AA_9_AA_8_AA_9_AA_1_ADFA_1_1_APBIDDDMADFB_-1_BMADAFBMFCBRAFAD_1_BRAPBRBRAFADFD_-1_1_APBRAFAPBRFE_1_-1_BMAFAP_0_ADFF_0_1_BMEOAFBMADFG_0_-1_ADFH_-1_-1_APBRAFBMADFIEU_4_DLED_-1_0_DSBQAF_-1_0_DSBQAF_1_1_BMAF_0_-1_BMAF_0_-1_BMAF_0_-1_BMAF_0_APBRAF_0_-1_AA_9
274,264,264,9,722,790,68,0,EY_9_AA_9_AA_1_AA_9_AA_2_AA_9_AA_3_AA_9_AA_4_AA_9_AA_5_AA_9_AA_6_AA_9_AA_7_AA_9_AA_8_AA_9_AA_1_ADFA_1_1_APBRAFBMADFB_-1_0_BRAFBMADADFC_-1_1_APBRADFD_1_BRAPBRAFBMADFE_1_-1_AP_0_AFBMADFF_0_1_APBRAFBMADFG_0_-1_AP_-1_BMAFBMFH_-1_-1_APBRAFBMADFIEU_4_DLED_-1_0_DSBQAF_-1_0_DSBQAF_1_1_BMAF_0_-1_BMAF_0_-1_BMAF_0_-1_BMAF_0_APBRAF_0_-1_BMA
275,263,263,8,722,748,26,0,EY_9_AA_9_AA_1_AA_9_AABS_29_2_AA_9_AA_3_AA_9_AA_4_AA_9_AA_5_AA_9_AA_6_AA_9_AA_7_AA_9_AA_8_AA_9_AA_1_ADFA_1_1_APBRAFBMADFB_-1_-1_APBRAFBMADFC_-1_1_APBRADFD_1_BRAPBRAFBMADFE_1_-1_AP_0_AFBMADFF_0_1_APBRAFBMADFG_0_-1_APBRAFBMADFH_-1_0_-1_BMAFBMADFIEU_4_DLED_-1_0_DSBQAF_-1_0_DSBQAF_1_1_BMAF_0_-1_BMAF_0_-1_BMAF_0_-1_BMAF_0_APBRAF_0_-1_BMA
276,191,191,9,723,935,212,0,16
277,68,68,11,724,789,65,0,1
278,203,203,17,725,0,-725,0,EY_9_AA_9_AA_1_BMAFAA_2_AA_9_AA_3_AA_9_AA_4_AW_13_AC_5_AA_9_AA_6_AADTEJ_9_AA_7_AA_9_AA_8_AA_9_AA_1_ADFA_1_1_APBIDDDMADFB_-1_0_-1_BMADAFBMFCBRAFAD_1_BRAPBRBRAFADFD_-1_1_APBRAFAPBRFE_1_-1_BMAFAP_0_ADFF_0_1_BMEOAFBMADFG_0_-1_ADFH_-1_-1_APBRAFBMADFIEU_4_DLED_-1_0_DSBQAF_-1_0_DSBQAF_1_1_BMAF_0_-1_BMAF_0_-1_BMAF_0_-1_BMAF_0_APBRAF_0_-1_AA_9
279,197,197,7,727,822,95,0,EY_9_AA_9_AA_1_AA_9_AA_2_AA_9_AA_3_AA_9_AA_4_AA_9_AA_5_AA_9_AAAA_7_AA_9_AA_8_AA_9_AA_1_ADFA_1_1_APBRAFBMADFB_-1_0_-1_BMAFBMADFC_-1_1_APBRAFBMADFD_1_0_APBRAFBMADFE_1_-1_APBRAFBMADAFFF_0_1_APBRAFBMADFG_0_-1_APBRAFBMADFH_-1_-1_AP_33_-10_BRAFBMADFIEU_4_DLED_-1_0_DSBQAF_-1_0_DSBQAF_1_1_BMAF_0_-1_BMAF_0_-1_BMAF_0_-1_BMAF_0_APBRAF_0_-1_BMA
280,267,267,11,728,0,-728,0,EY_9_AA_9_AA_1_AA_9_AA_2_AA_9_AA_3_AA_9_AA_4_AA_9_AA_5_AA_9_AA_6_AA_9_AA_7_AA_9_AA_8_AA_9_AA_1_ADFA_1_1_APBRAFBMADFB_-1_0_-1_BM_0_-1_BMAFBMADFC_-1_APBRAFADFD_1_BMADFE_-1_APBR_0_AFBMADFF_0_1_-26_AJAPBRAFBMADFG_0_-1_1_APBRBMADFH_-1_1_-1_APAFBMADFIEU_4_DLED_-1_0_DSBQAF_54_77_-1_0_DSBQAF_1_1_BMAF_0_-1_BMAF_0_-1_BMAF_0_-1_BMAF_0_APBRAF_0_-1_BMA
281,238,238,7,729,741,12,0,EY_9_AA_9_AA_1_AA_9_AA_2_AA_9_AA_3_AA_9_AA_4_AA_9_AA_5_AA_9_AA_6_AA_9_AA_7_AA_9_AA_8_AA_9_AA_1_ADFA_1_1_APBRAFBMADFB_-1_0_-1_BMAFBMADFC_-1_1_APBRADFD_1_BRAPBRAFBMADFE_1_-1_AP_0_AFBMADFF_0_1_APBRAFBMFG_0_-1_APBRAFBMADFH_-1_-1_APBRAFBMADFIEU_4_DLED_-1_0_DSBQAF_-1_0_DSBQAF_1_1_BMAF_0_-1_BMAF_0_-1_BMAF_0_-1_BMAF_0_APBRAF_0_-1_BMA
282,240,240,18,731,0,-731,0,EY_9_AA_9_AA_1_BMAFAA_2_AA_9_AA_3_AA_9_AA_4_AW_13_AC_5_AA_9_AA_6_AADTEJ_9_AA_7_AA_9_AA_8_AA_9_AA_1_ADFA_1_1_APBIDDDMADFB_-1_0_-1_BMADAFBMFCBRAFAD_1_BRAPBRBRAFADFD_-1_1_APBRAFAPBRFE_1_-1_BMAFAP_0_ADFF_0_1_BMAFBMADFG_0_-1_ADFH_-1_-1_APBRAFBMADFIEU_4_DLED_-1_0_DSBQAF_-1_0_DSBQAF_1_1_BMAF_0_-1_BMAF_0_-1_BMAF_0_-1_BMAF_0_APBRAF_0_-1_AA_9
283,243,243,8,732,0,-732,0,14
284,67,67,7,736,748,12,0,EY_9_AA_9_AA_1_AA_9_AA_2_AA_9_AA_3_AA_9_AA_4_AA_9_AA_5_AA_9_AA_6_AA_9_AA_7_AA_9_AA_8_AA_9_AA_1_ADFA_1_1_APBRAFBMADFB_-1_0_-1_BMAFBMADFC_-1_FD_1_BRAPBRAFBMADFE_0_AFBMADFF_0_1_APBRAFBMFG_0_-1_APBRAFBMADFH_-1_-1_APBRAFBMADFIEU_4_DLED_-1_0_DSBQAF_-1_0_DSBQAF_1_1_BMAF_0_-1_BMAF_0_-1_BMAF_0_-1_BMAF_0_APBRAF_0_-1_BMA
285,273,273,18,736,0,-736,0,EY_9_AA_9_AA_1_BMAFAA_2_AA_9_AA_3_AA_9_AA_4_AW_13_AC_5_AA_9_AA_6_AA_9_AA_7_AA_9_AA_8_AA_9_AA_1_ADFA_1_1_APBIDDDMADFB_-1_BMADAFBMFCBRAFAD_1_BRAPBRBRAFADFD_-1_1_APBRAFAPBRFE_1_-1_BMAFAP_0_ADFF_0_1_BMEOAFBMADFG_0_-1_ADFH_-1_-1_APBRAFBMADFIEU_4_DLED_-1_0_DSBQAF_-1_0_DSBQAF_1_1_BMAF_0_-1_BMAF_0_-1_BMAF_0_-1_BMAF_0_APBRAF_0_-1_AA_9
286,276,276,10,738,932,194,0,16
287,277,277,12,739,805,66,0,1
288,279,279,8,742,774,32,0,EY_9_AA_9_AA_1_AA_9_AA_2_AA_9_AA_3_AA_9_AA_4_AA_9_AA_5_AA_9_AAAA_7_AA_9_AA_8_AA_9_AA_1_ADFA_1_1_APBRAFBMADFB_-1_0_-1_BMAFBMADFC_-1_1_APBRAFBMADFD_1_0_APBRAFBMADFE_1_-1_APBRAFBMADAFFF_0_1_APBRAFBMADFG_0_-1_APBRAFBMADFH_-1_-1_AP_33_-10_BRAFBMADFIEU_4_DLED_-1_0_DSBQAF_-1_0_DSBQAF_1_1_BMAF_0_-1_BMAF_0_-1_BMAF_0_-1_BMAF_0_APBRAF_0_-1_BMA
289,250,250,8,743,0,-743,0,EY_9_AA_9_AA_1_AA_9_AA_2_AA_9_AA_3_AA_9_AA_4_AA_9_AA_5_AA_9_AA_6_AA_9_AA_7_AA_9_AA_8_AA_9_AA_1_ADFA_1_1_APBRAFBMADFB_-1_0_-1_BMAFBMADFC_-1_1_APBRADFD_1_BRAPBRAFBMADFE_1_-1_AP_0_AFBMADFF_0_BMADFG_-1_-1_APBRAFBMADFHEU_4_DLED_-1_0_DSBQAF_-1_0_DSBQAF_1_1_BMAF_0_-1_BMAF_0_-1_BMAFBMAF_0_APBRAF_0_-1_BMA
290,280,280,12,745,0,-745,0,EY_9_AA_9_AA_1_AA_9_AA_2_AA_9_AA_3_AA_9_AA_4_AA_9_AA_5_AA_9_AA_6_AA_9_AA_7_AA_9_AA_8_AA_9_AA_1_ADFA_1_1_APBRAFBMADFB_-1_0_-1_BM_0_-1_BMAFBMADFC_-1_APBRAFADFD_1_BMADFE_-4_APBR_2_AFBMADFF_0_1_-26_AJAPBRAFBMADFG_-1_3_5_APBRBMADFH_-1_1_-1_APAFBMADFIEU_4_DLED_-1_0_DSBQAF_54_77_-1_0_DSBQAF_1_1_BMAF_0_-1_BMAF_0_-1_BMAF_0_-1_BMAF_0_APBRAF_0_-1_BMA
291,283,283,9,747,882,135,0,14
292,210,210,7,749,1003,254,0,7
293,212,212,13,750,0,-750,0,6
294,160,160,16,751,781,30,0,EY_9_AA_9_AA_1_BMAFAA_2_AA_9_AA_3_AA_9_AA_4_AW_13_AC_5_AA_9_AA_6_AA_9_AA_7_AA_9_AA_8_AA_9_AA_1_ADFA_1_1_APBIDDDMADFB_-1_0_-1_BMADAFDP_27_AJ_-70_BMFCBRAFAD_1_BRAPBRBRAFADFD_-1_1_APBRAFAPBRFE_1_-1_BMAFAP_0_ADFF_0_1_BMEOAFBMADFG_0_-1_ADFH_-1_-1_APBRAFBMADFIEU_4_DLED_-1_0_DSBQAF_-1_0_DSBQAF_1_1_BMAF_0_-1_BMAF_0_-1_BMAF_0_-1_BMAF_0_APBRAF_0_-1_AA_9
295,255,255,10,754,899,145,0,EY_9_AA_9_AA_1_AA_9_AA_2_AA_9_AA_3_AA_9_AA_4_AA_9_AA_5_AA_9_AA_6_AA_9_AA_7_AA_9_AA_8_AA_9_AA_1_ADFA_1_1_APBRAFBMADFB_-1_0_-1_BMAFBMADFC_-1_1_APBRADFD_1_BRAPBRAFBMADFE_-1_APBR_0_AFBMADFF_0_1_APBRAFBMADFG_0_-1_APBRAFBMADFH_-1_1_-1_APAFBMADFIEU_4_DLED_-1_0_DSBQAF_54_77_-1_0_DSBQAF_1_1_BMAF_0_-1_BMAF_0_-1_BMAF_0_-1_BMAF_0_APBRAF_0_-1_BMA
296,287,287,13,754,754,0,0,1
297,257,257,9,757,0,-757,0,EY_9_AA_9_AA_1_AA_9_AA_9_AA_3_AA_9_AA_4_AA_9_AA_5_AA_9_AA_6_AA_9_AA_7_AA_9_AA_8_AA_9_AA_1_ADFABRAFBMAD_1_1_APBRAFBMADFBEF_-7_ER_-1_0_APBRAFBMADFC_-1_1_APBRBRAFBMADFD_1_0_APBRAFBMAD_-59_13_FE_1_-1_APBRADAFBMADAPBRAFFF_0_1_APBRAFBMADFG_0_-1_ADFH_-1_-1_APBR_-1_APBRAFBMADFIEU_4_DLED_-1_0_DSBQAF_-1_0_DSBQAF_1_1_BMAF_0_-1_BMAF_0_-1_BMAF_0_-1_BMAF_0_APBRAF_0_-1_BMA
298,288,288,9,757,796,39,0,EY_9_AA_9_AA_1_AA_9_AA_2_AA_9_AA_3_AA_9_AA_4_AA_9_AA_5_AA_9_AAAA_7_AA_9_AA_8_AA_9_AA_1_ADFA_1_1_APBRAFBMADFB_-1_0_-1_BMAFBMADFC_-1_1_APBRAFBMADFD_1_0_APBRAFBMADFE_1_-1_APBRAFBMADAFFF_0_1_APBRAFBMADFG_0_-1_APBRAFBMADFH_-1_-1_AP_33_-10_BRAFBMADFIEU_4_DLED_-1_0_DSBQAF_-1_0_DSBQAF_1_1_BMAF_0_-1_BMAF_0_-1_BMAF_0_-1_BMAF_0_APBRAF_0_-1_BMA
299,174,174,7,760,954,194,0,12
300,199,199,17,762,975,213,0,EY_9_AA_9_AA_1_BMAFAA_2_AA_9_AA_3_AA_9_AA_4_AW_13_AC_5_AA_9_AA_6_AA_9_AA_7_AA_9_AA_8_AA_9_AA_1_ADFA_1_1_APBIDDDMADFB_-1_0_-1_BMADAFBMFCBRAFBRBRAFADFD_1_-1_BMAFAP_0_ADFE_0_1_BMAFBMADFF_0_-1_ADFG_-1_-1_APBRAFBMADFHEU_4_DLED_-1_0_DSBQAF_-1_0_DSBQAF_1_1_BMAF_0_-1_BMAF_0_-1_BMAF_0_-1_BMAF_0_APBRAF_0_-1_AA_9
301,291,291,10,762,958,196,0,14
302,264,264,9,763,0,-763,0,EY_9_AA_9_AA_1_AA_9_AA_2_AA_9_AA_3_AA_9_AA_4_AA_9_AA_5_AA_9_AA_6_AA_9_AA_7_AA_9_AA_8_AA_9_AA_1_ADFA_1_1_APBRAFBMADFB_-1_0_BRAFBMADADFC_-1_1_APBRADFD_1_BRAPBRAFBMADFE_1_-1_EE_-4_EFBMADFF_0_1_APBRAFBMADFG_0_-1_AP_-1_BMAFBMFH_-1_-1_APBRAFBMADFIEU_4_DLED_-1_0_DSBQAF_-1_0_DSBQAF_1_1_BMAF_0_-1_BMAF_0_-1_BMAF_0_-1_BMAF_0_APBRAF_0_-1_BMA
303,292,292,8,764,772,8,0,EY_9_AA_9_AA_1_AA_9_AA_2_AA_9_AA_3_AAAA_9_AA_5_AA_9_AA_6_AA_9_AA_7_AA_9_AA_8_AA_9_AA_1_ADFA_1_1_APBRAFBMADFB_-1_0_APBRAFBMADFC_-1_1_APBRAFBMADFD_1_0_APBRAFBMADFE_1_-1_APBRAFBMADFF_0_APBRAFBMADFG_0_-1_APBRAFBMADFH_-1_-1_APBRAFBMADFIEU_4_DLED_-1_0_DSBQAF_-1_0_DSBQAF_1_1_BMAF_0_-1_BMAF_0_-1_BMAF_0_-1_BMAF_0_-1_BMAF_0_-1_BMA
304,232,232,17,766,857,91,0,0
305,294,294,17,766,785,19,0,EY_9_AA_9_AA_1_BMAFAA_2_AA_9_AA_3_AA_9_AA_4_AW_13_AC_5_AA_9_AA_6_AA_9_AA_7_AA_9_AA_8_AA_9_AA_1_ADFA_1_1_APBIDDDMADFB_-1_0_-1_BMADAF_27_AJ_-70_BMFCBRAFAD_1_BRAPBRBRAFADFD_-1_1_APBRAFAPBRFE_1_-1_BMAFAP_0_ADFF_0_1_BMEOAFBMADFG_0_-1_ADFH_-1_-1_APBRAFBMADFIEU_4_DLED_-1_0_DSBQAF_-1_0_DSBQAF_1_1_BMAF_0_-1_BMAF_0_-1_BMAF_0_-1_BMAF_0_APBRAF_0_-1_AA_9
306,295,295,11,771,811,40,0,EY_9_AA_9_AA_1_AA_9_AA_2_AA_9_AA_3_AA_9_AA_4_AA_9_AA_5_AA_9_AA_6_AA_9_AA_7_AA_9_AA_8_AA_9_AA_1_ADFAAD_1_1_APBRAFBMADFB_-1_0_-1_BMAFBMADFC_-1_1_APBRADFD_1_BRAPBRAFBMADFE_-1_APBR_0_AFBMADFFBRAFBMADFG_0_-1_APBRAFBMADFH_-1_1_-1_APAFBMADFIEU_4_DLED_-1_0_DSBQAF_54_77_-1_0_DSBQAF_1_1_BMAF_0_-1_BMAF_0_-1_BMAF_0_-1_BMAF_0_APBRAF_0_-1_BMA
307,226,301,11,772,875,103,75,EY_9_AA_9_AA_1_AA_9_AA_2_AA_9_AA_3_AA_9_AA_4_AA_9_AA_5_AA_9_AA_6_AA_9_AA_7_AA_9_AA_8_AA_9_AA_1_ADFA_1_1_APBRAFBMADFB_-1_0_-1_BMAFBMADFC_-1_1_APBRAFBMADFD_1_BRAPBRAFBMADFE_1_-1_APBRAFBMADAFFF_0_1_APBRAFBMADFG_0_-1_APBRAFBMADFH_-1_-1_APBRAFBMADFIEU_4_DLED_-1_0_DSBQAF_-1_0_DSBQAF_1_1_BMAF_0_-1_BMAF_0_-1_BMAF_0_-1_BMAF_0_APBRAF_0_-1_BMA
308,299,299,8,775,781,6,0,12
309,117,117,9,780,847,67,0,EY_9_AA_9_AA_1_AA_9_AA_2_AA_9_AA_3_AA_9_AA_4_AA_9_AA_5_AA_9_AA_6_AA_9_AAAA_9_AA_8_AA_9_AA_1_ADFA_1_1_APAFBMBMADFB_-1_0_-1_BMAFBMADFCAFBMADFD_1_BRAPBRAQAOBRAFADFE_1_-1_AP_0_FF_0_1_APBRAFBMADFG_0_-1_APBRADFH_1_3_APBRAFBMADFIEU_4_DLED_-1_0_DSBQAF_-1_0_DSBQAF_1_1_BMAF_0_-1_BMAF_0_-1_BMAF_0_-1_BMAF_0_APBR_0_-1_BMA
310,217,217,8,780,834,54,0,EY_9_AA_9_AA_1_AA_9_AA_9_AA_3_AA_9_AA_4_AA_9_AA_5_AA_9_AA_6_AA_9_AA_7_AA_9_AA_8_AA_9_AA_1_ADFA_1_1_APBRAFBMADFBEF_-7_ER_-1_0_APBRAFBMADFC_-1_1_APBRBRAFBMAFBMADFD_1_0_APBRAFBMAD_-59_13_FE_1_-1_APBRAFBMADAPBRAFFF_0_1_APBRAFBMADFG_0_-1_APBRAFBMADFH_-1_-1_APBR_-1_APBRAFBMADFIEU_4_DLED_-1_0_DSBQAF_-1_0_DSBQAF_1_1_BMAF_0_-1_BMAF_0_-1_BMAF_0_-1_BMAF_0_APBRAF_0_-1_BMA
311,235,235,15,780,814,34,0,EY_9_AA_9_AA_1_AA_9_BW_4_AA_9_AA_3_AA_9_AA_4_AA_9_AA_5_AAAA_9_AA_7_9_AA_8_AA_9_AA_1_ADFAAD_1_APBRAFBM_1_FB_-1_-1_0_AFBMADFC_-1_1_APBRBMADADFD_1_0_APBRAFBCBIFE_1_-1_APBRADFF_0_1_APBRAFBMBJEWBHBVADFG_0_-1_ECAPBRAFBMADFH_-1_-1_APBRAFBMADFIEU_4_DLED_-1_0_DSBQAF_-1_0_DSBQAF_1_1_BMAF_0_-1_BMAF_0_-1_BMAF_0_-1_BMAF_0_-1_BMA
312,234,234,15,780,0,-780,0,EY_9_AA_9_AA_1_AA_9_BW_4_AA_9_AA_3_AA_9_AA_4_AA_9_AA_5_AA_-80_AA_9_AA_7_9_AA_8_AA_9_AA_1_ADFAAD_1_APBRAFBM_1_FB_-1_0_APAFAFBMADFC_-1_1_APBRBMADADFD_1_0_APBRAFBCBIFE_1_-2_AUEUAHFF_0_1_APBRAFBMADFG_0_-1_APBRAFBMBMADFH_-1_-1_ECAPBRAFADFIEU_4_DLED_-1_0_DSBQAF_-1_0_DSBQAF_1_1_BMAF_0_-1_BMAF_0_-1_BMAF_0_-1_BMAF_0_-1_BMA
313,277,277,12,780,805,25,0,EY_9_AA_9_AA_1_AA_9_AA_2_AA_9_AA_3_AA_9_AA_4_AA_9_AA_5_AA_9_AA_6_AA_9_AA_7_AA_9_AA_8_AA_9_AA_1_ADFA_1_1_APBRAFBMADFB_-1_0_-1_BMAFBMADFC_-1_1_APBRAFBMADFD_1_BRAPBRAFBMADFE_1_AP_0_AFBM_-1_AP_0_AFBMADFF_0_1_APBRAFBMADFGFH_-1_-1_APEQAFBMADFIEU_4_DLED_-1_0_DSBQAF_-1_0_DSBQAF_1_1_BMAF_0_-1_BMAF_0_-1_BMAF_0_-1_BMAF_0_APBRAF_0_-1_BMA
314,86,86,13,781,819,38,0,EY_9_AA_9_AA_1_AA_9_AA_2_AA_9_AA_3_AA_9_AA_4_AA_9_AA_5_AA_9_AA_6_AA_9_AA_7_AA_9_AA_8_AA_9_AA_1_ADFA_1_1_APBRAFBMADFB_-1_0_-1_BMAFBMADFC_-1_1_APBRAFBMADFD_1_BRAFBMAPBRAFBMADFE_1_AP_0_AFBM_-1_AP_0_AFBMADFF_0_1_APBRAFBMADFG_0_-1_FH_-1_-1_APEQAFBMADFIEU_4_DLED_-1_0_DSBQAF_-1_0_DSBQAF_1_1_BMAF_0_-1_BMAF_0_-1_BMAF_0_-1_BMAF_0_APBRAF_0_-1_BMA
315,91,91,15,781,796,15,0,0
316,246,246,18,781,0,-781,0,0
317,245,245,18,781,958,177,0,0
318,304,304,18,781,0,-781,0,EY_9_AA_9_AA_1_BMAFAA_2_AA_9_AA_3_AA_9_AA_4_AW_13_AC_5_AA_9_AA_6_AA_9_AA_7_AA_9_AA_8_AA_9_AA_1_ADFA_-1_0_-1_BMADAFBMFBBRAFAD_1_BRAPBRBRAFADFC_-1_1_APBRAFAPBRFD_1_-1_BMAFAP_0_ADFE_0_1_BMEOAFBMADFF_0_-1_ADFG_-1_-1_APBRAFBMADFHEU_4_DLED_-1_0_DSBQAF_-1_0_DSBQAF_1_1_BMAF_0_-1_BMAF_0_-1_BMAF_0_-1_BMAF_0_APBRAF_0_-1_AA_9
319,279,279,8,783,887,104,0,EY_9_AA_9_AA_1_AA_9_AA_2_AA_9_AA_3_AA_9_AA_4_AA_9_AA_5_AA_9_AAAA_7_AA_9_AA_1_ADFA_1_1_APBRAFBMADFB_-1_0_-1_BMAFBMADFC_-1_1_APBRAFBMADFD_1_0_APBRAFBMADFE_1_-1_APBRAFBMADAFFF_0_1_APBRAFBMADFG_0_-1_APBRAFBMADFH_-1_-1_AP_33_-10_BRAFBMADFIEU_4_DLED_-1_0_DSBQAF_-1_0_DSBQAF_1_1_BMAF_0_-1_BMAF_0_-1_BMAF_0_-1_BMAF_0_APBRAF_0_-1_BMA
320,237,237,15,786,0,-786,0,EY_9_AA_9_AA_1_AA_9_AA_2_AA_9_AA_3_AA_9_AA_4_AA_9_AA_5_AA_9_AA_6_AA_9_AA_7_AA_9_AA_8_AA_9_AA_1_ADFA_1_92_-6_EJDD_1_AP_-6_BRAFBMADFB_-1_0_-1_BMAFBMADFC_1_4_AYFD_1_BRAPBRAFBMADFE_1_-1_AP_0_AFBMADFF_0_FG_0_-1_APFH_-1_-1_APBR_-1_0_DSFIEU_6_DLED_-4_-2_DSBQAF_-4_-2_DSBQAF_4_-3_BMAF_2_1_BMAF_-1_2_BQBMAF_3_3_BMAF_4_APBRAF_2_-5_BMA
321,206,206,7,787,0,-787,0,EY_9_AA_9_AA_1_AA_9_AA_2_AA_9_AA_3_AA_9_AA_4_AA_9_AA_5_AA_9_AA_6_AA_9_AA_7_AA_9_AA_8_AA_9_AA_1_ADFA_1_1_APBRAFBMADFB_-1_0_-1_BMAFBMADFC_-1_1_APBRADFD_1_BRAPBRAFBMADFE_1_-1_AP_0_AFBMADFF_0_1_APBRAFBMADFG_-1_-1_APBRAFBMADFHEU_4_DLED_-1_0_DSBQ_0_DSBQAF_1_1_BMAF_0_-1_BMAF_0_-1_BMAF_0_-1_BMAF_0_APBRAF_0_-1_BMA
322,307,307,12,787,0,-787,0,EY_9_AA_9_AA_1_AA_9_AA_2_AA_9_AA_3_AA_9_AA_4_AA_9_AA_5_AA_9_AA_6_AA_9_AA_7_AA_9_AA_8_AA_9_AA_1_ADFA_1_1_APBRAFBMADFB_-1_0_-1_BMAFBMADFC_-1_1_APBRAFBMADFDBRAPBRAFBMADFE_1_-1_APBRAFBMADAFFF_0_1_APBRAFBMADFG_0_-1_APBRAFBMADFH_-1_-1_APBRAFBMADFIEU_4_DLED_-1_0_DSBQAF_-1_0_DSBQAF_1_1_BMAF_0_-1_BMAF_0_-1_BMAF_0_-1_BMAF_0_APBRAF_0_-1_BMA
323,280,280,12,788,0,-788,0,EY_9_AA_9_AA_1_AA_9_AA_2_AA_9_AA_3_AA_9_AA_4_AA_9_AA_5_AA_9_AA_6_AA_9_AA_7_AA_9_AA_8_AA_9_AA_1_ADFA_1_1_APBRAFBMADFB_-1_0_-1_BM_0_-1_BMAFBMADFC_-1_APBRAFADFD_1_FE_-1_APBR_0_AFADFF_0_1_-26_AJAPBRAFBMADFG_0_-1_1_APBRBMADFH_-1_1_-1_APAFBMADFIEU_4_DLED_-1_0_DSBQAF_54_77_-1_0_DSBQAF_1_1_BMAF_0_-1_BMAF_0_-1_BMAF_0_-1_BMAF_0_APBRAF_0_-1_BMA
324,283,283,9,788,863,75,0,14
325,263,310,9,790,861,71,47,EY_9_AA_9_AA_1_AA_9_AABS_29_2_AA_9_AA_3_AA_9_AA_4_AA_9_AA_5_AA_9_AA_6_AA_9_AA_7_AA_9_AA_8_AA_9_AA_1_ADFA_1_1_APBRAFBMADFBEF_-7_ER_-1_0_APBRAFBMADFC_-1_1_APBRADFD_1_BRAPBRAFBMADFE_1_-1_APBRAFBMADAPBRAFFF_0_1_APBRAFBMADFG_0_-1_APBRAFBMADFH_-1_-1_APBRAFBMADFIEU_4_DLED_-1_0_DSBQAF_-1_0_DSBQAF_1_1_BMAF_0_-1_BMAF_0_-1_BMAF_0_-1_BMAF_0_APBRAF_0_-1_BMA
326,160,160,16,792,0,-792,0,EY_9_AA_9_AA_1_BMAFAA_2_AA_9_AA_3_AA_9_AA_4_AW_13_AC_5_AA_9_AA_6_AA_9_AA_7_AA_9_AA_8_AA_9_AA_1_ADFA_1_1_APBIDDDMADFB_-1_0_-1_BMADAFBMFCBRAFAD_1_BRAPBRBRAFADFD_-1_1_APBRAFAPBRFE_1_-1_BMAFAP_0_ADFF_0_1_BMEOAFBMADFG_0_-1_AD_0_-1_ADFH_-1_-1_APBRAFBMADFIEU_4_DLED_-1_0_DSBQAF_-1_0_DSBQAF_1_-49_-81_AK_1_BMAF_0_-1_BMAF_0_-1_BMAF_0_-1_BMAF_0_APBRAF_0_-1_AA_9
327,186,186,13,792,0,-792,0,EY_9_AA_9_AA_1_BMAFAA_2_AA_9_AA_3_AA_9_AA_4_AA_9_AA_5_AA_9_AA_6_AA_9_AA_7_AA_9_AA_8_AA_9_AA_1_ADFA_1_1_APBIDDDMADFB_-1_0_-1_AP_0_AFBMFC_-1_1_APBRAFAPBRFD_1_BRAPBRBRAFADFE_1_-1_BMAFEXAJADFF_0_1_BMADAFBMADFG_0_-1_APBRAFADFH_-1_-1_APBRAFBMADFIEU_4_DLED_-1_0_DSBQAF_-1_0_DSBQAF_1_1_BMAF_0_-1_BMAF_0_-1_BMAF_0_-1_BMAF_0_APBRAF_0_-1_AA_9
328,287,287,13,795,938,143,0,1
329,313,313,13,795,875,80,0,EY_9_AA_9_AA_1_AA_9_AA_2_AA_9_AA_3_AA_9_AA_4_AA_9_AA_5_AA_9_AA_6_AA_9_AA_7_AA_9_AA_8_AA_9_AA_1_ADFA_1_1_APBRAFBMADFB_-1_0_-1_BMAFBMADFC_-1_1_APBRAFBMADFD_1_BRAPBRAFBMADFE_1_AP_0_AFBM_-1_AP_0_AFBMADFF_0_1_APBRAFBMADFGFH_-1_-1_APEQAFBMADFIEU_4_DLED_-1_0_DSBQAF_-1_0_DSBQAF_1_1_BMAF_0_-1_BMAF_0_-1_BMAF_0_-1_BMAF_0_APBRAF_0_-1_BMA
330,309,309,10,795,841,46,0,EY_9_AA_9_AA_1_AA_9_AA_2_AA_9_AA_3_AA_9_AA_4_AA_9_AA_5_AA_9_AA_6_AA_9_AAAA_9_AA_8_AA_9_AA_1_ADFA_1_1_APAFBMBMADFB_-1_0_-1_BMAFBMADFCAFBMADFD_1_BRAPBRAQAOBRAFADFE_1_-1_AP_0_FF_0_1_APBRAFBMADFG_0_-1_APBRADFH_1_3_APBRAFBMADFIEU_4_DLED_-1_BQAF_-1_0_DSBQAF_1_1_BMAF_0_-1_BMAF_0_-1_BMAF_0_-1_BMAF_0_APBR_0_-1_BMA
331,317,317,19,796,1013,217,0,0
332,314,314,14,796,835,39,0,EY_9_AA_9_AA_1_AA_9_AA_2_AA_9_AA_3_AA_9_AA_4_AA_9_AA_5_AA_9_AA_6_AA_9_AA_7_AA_9_AA_8_AA_9_AA_1_ADFA_1_1_APBRAFBMADFB_-1_0_-1_BMAFBMADFC_-1_1_APBRAFBMADFD_1_BRAFBMAPBRAFBMADFE_1_AP_0_AFBM_-1_AP_0_AFBMADFF_0_1_APBRAFBMADFG_0_-1_FH_-1_-1_APEQAFBMADFIEU_4_DLED_-1_0_DSBQAF_-1_0_DSBQAF_1_1_BMAF_0_-1_BMAF_0_-1_BMAF_0_-1_BMAF_0_APBRAF_0_-1_BMA
333,80,80,12,801,0,-801,0,1
334,320,320,16,801,978,177,0,EY_9_AA_9_AA_1_AA_9_AA_2_AA_9_AA_3_AA_9_AA_4_AA_9_AA_5_AA_9_AA_6_AA_9_AA_7_AA_9_AA_8_AA_9_AA_1_ADFA_1_92_-6_EJDD_1_AP_-6_BRAFBMADFB_-1_0_-1_BMAFBMADFC_1_4_AYFD_1_BRAPBRAFBMADFE_1_-1_AP_0_AFBMADFF_0_FG_0_-1_APFH_-1_-1_APBR_-1_0_DSFIEU_6_DLED_-4_-2_DSBQAF_-4_-2_DSBQAF_4_-3_BMAF_2_1_BMAF_-1_2_BQBMAF_3_3_BMAF_4_APBRAF_2_-5_BMA
335,322,322,13,802,851,49,0,EY_9_AA_9_AA_1_AA_9_AA_2_AA_9_AA_3_AA_9_AA_4_AA_9_AA_5_AA_9_AA_6_AA_9_AA_7_AA_9_AA_8_AA_9_AA_1_ADFA_1_1_APBRAFBMADFB_-1_0_-1_BMAFBMADFCAFBMADFDBRAPBRAFBMADFE_1_-1_APBRAFBMADAFFF_0_1_APBRAFBMADFG_0_-1_APBRAFBMADFH_-1_-1_APBRAFBMADFIEU_4_DLED_-1_0_DSBQAF_-1_0_DSBQAF_1_1_BMAF_0_-1_BMAF_0_-1_BMAF_0_-1_BMAF_0_APBRAF_0_-1_BMA
336,292,292,8,805,0,-805,0,EY_9_AA_9_AA_1_AA_9_AA_2_AA_9_AA_3_AA_9_AA_4_AA_9_AA_5_AA_9_AA_6_AA_9_AA_7_AA_9_AA_8_AA_9_AA_1_ADFA_1_1_APBRAFBMADFB_-1_0_APBRAFBMADFC_-1_1_APBRAFBMADFD_1_0_APBRAFBMADFE_1_BMADFF_0_APBRAFBMADFG_0_-1_APBRAFBMADFH_-1_-1_APBRAFBMADFIEU_4_DLED_-1_0_DSBQAF_-1_0_DSBQAF_1_1_BMAF_0_-1_BMAF_0_-1_BMAF_0_-1_BMAF_0_-1_BMAF_0_-1_BMA
337,323,323,13,805,0,-805,0,EY_9_AA_9_AA_1_AA_9_AA_2_AA_9_AA_3_AA_9_AA_4_AA_9_AA_5_AA_9_AA_6_AA_9_AA_7_AA_9_AA_8_AA_9_AA_1_ADFA_1_1_APBRAFBMADFB_-1_0_-1_BM_0_-1_BMAFBMADFC_-1_ADFD_1_FE_-1_APBR_0_AFADFF_0_1_-26_AJAPBRAFBMADFG_0_-1_1_APBRBMADFH_-1_1_-1_APAFBMADFIEU_4_DLED_-1_0_DSBQAF_54_77_-1_0_DSBQAF_1_1_BMAF_0_-1_BMAF_0_-1_BMAF_0_-1_BMAF_0_APBRAF_0_-1_BMA
338,199,199,17,807,0,-807,0,EY_9_AA_9_AA_1_BMAFAA_2_AA_9_AA_3_AA_9_AA_4_AW_13_AC_5_AA_9_AA_6_AA_9_AA_7_AA_9_AA_8_AA_9_AA_1_ADFA_1_1_APBIDDDMADFB_-1_0_-1_BMADAFBMFCBRAFAD_1_BRAPBRBRAFADFD_-1_1_APBRAFAPBRFE_1_-1_BMAFAP_0_ADFF_0_1_BMAFBMADFG_0_-1_ADFH_-1_-1_APBRAFBMADFIEU_4_DLED_-1_0_DSBQAF_-1_0_DSBQAF_1_1_BMAF_0_-1_BMAF_0_-1_BMAF_0_-1_BMAF_0_APBRAF_0_-1_AA_9
339,259,259,17,807,0,-807,0,0
340,93,93,14,810,842,32,0,EY_9_AA_9_AA_1_AA_9_AA_2_AA_9_AA_3_AA_9_AA_4_AA_9_AA_5_AA_9_AA_6_AA_9_AA_7_AA_9_AA_8_AA_9_AA_1_ADFA_1_APBR_1_APBRAFBMADFB_-1_0_-1_BMAFBMADFC_-1_1_APBRAFBMADFD_1_BRAFBMAPBRAFBMADFE_1_AP_0_AFBM_-1_AP_0_AFBMADFF_0_1_APBRAFBMADFG_0_-1_-1_FH_-1_-1_APEQAFBMADFIEU_4_DLED_-1_0_DSBQAF_-1_0_DSBQAF_1_1_BMAF_0_-1_BMAF_0_-1_BMAF_0_-1_BMAF_0_APBRAF_0_-1_BMA
341,329,329,14,810,991,181,0,EY_9_AA_9_AA_1_AA_9_AA_2_AA_9_AA_3_AA_9_AA_4_AA_9_AA_5_AA_9_AA_6_AA_9_AA_7_AA_9_AA_8_AA_9_AA_1_ADFA_1_1_APBRAFBMADFB_-1_0_-1_BMAFBMADFC_-1_1_APBRAFBMADFD_1_BRAPBRAFBMADFE_1_AP_0_AFBM_-1_AP_0_AFBMADFF_0_1_APBRAFBMADFGFH_-1_-1_APEQAFBMADFIEU_4_DLED_-1_0_DSBQAF_-1_0_DSBQAF_1_1_BMAF_0_-1_BMAF_0_-1_BMAF_0_-1_BMAF_0_APBRAF_0_-1_BMA
342,328,328,14,810,839,29,0,1
343,201,201,9,811,0,-811,0,5
344,203,203,17,811,0,-811,0,EY_9_AA_9_AA_1_BMAFAA_2_AA_9_AA_3_AA_9_AA_4_AW_13_AC_5_AA_9_AA_6_AADTEJ_9_AA_7_AA_9_AA_8_AA_9_AA_1_ADFA_1_1_APBIDDDMADFB_-1_0_-1_BMADAFBMFCBRAFAD_1_BRAPBRBRAFADFD_-1_1_APBRAFAPBRFE_1_-1_BMAFAP_0_ADFF_0_1_BMEOAFBMADFG_0_-1_ADFH_-1_-1_APBRAFBMADFIEU_5_DLED_0_0_DSBQAF_0_1_DSBQAF_0_-1_BMAF_-1_-2_BMAF_0_3_BMAF_-1_-3_BMAF_0_APBRAF_-4_-5_AA_12
345,332,332,15,811,993,182,0,EY_9_AA_9_AA_1_AA_9_AA_2_AA_9_AA_3_AA_9_AA_4_AA_9_AA_5_AA_9_AA_6_AA_9_AA_7_AA_9_AA_8_AA_9_AA_1_ADFA_1_1_APBRAFBMADFB_-1_0_-1_BMAFBMADFC_-1_1_APBRAFBMADFD_1_BRAFBMAPBRAFBMADFE_1_AP_0_AFBM_-1_AP_0_AFBMADFF_0_1_APBRAFBMADFG_0_-1_FH_-1_-1_APEQAFBMADFIEU_4_DLED_-1_0_DSBQAF_-1_0_DSBQAF_1_1_BMAF_0_-1_BMAF_0_-1_BMAF_0_-1_BMAF_0_APBRAF_0_-1_BMA
346,295,295,11,814,866,52,0,EY_9_AA_9_AA_1_AA_9_AA_2_AA_9_AA_3_AA_9_AA_4_AA_9_AA_5_AA_9_AA_6_AA_9_AA_7_AA_9_AA_8_AA_9_AA_1_ADFA_1_1_APBRAFBMADFB_-1_0_-1_BMAFBMADFC_-1_1_APBRADFDBRAFBMADFE_-1_APBR_0_AFBMADFF_0_1_APBRAFBMADFG_0_-1_APBRAFBMADFH_-1_1_-1_APAFBMADFIEU_4_DLED_-1_0_DSBQAF_54_77_-1_0_DSBQAF_1_1_BMAF_0_-1_BMAF_0_-1_BMAF_0_-1_BMAF_0_APBRAF_0_-1_BMA
347,299,299,8,815,826,11,0,12
348,85,85,13,816,0,-816,0,4
349,217,217,8,821,893,72,0,EY_9_AHAA_9_AA_1_AA_9_AA_9_AA_3_AA_9_AA_4_AA_9_AA_5_AA_9_AA_6_AA_9_AA_7_AA_9_AA_8_AA_9_AA_1_ADFA_1_1_APBRAFBMADFBEF_-7_ER_-1_0_APBRAFBMADFCBRAFBMAFBMADFD_1_0_APBRAFBMAD_-59_13_FE_1_-1_APBRAFBMADAPBRAFFF_0_1_APBRAFBMADFG_0_-1_APBRAFBMADFH_-1_-1_APBR_-1_APBRAFBMADFIEU_4_DLED_-1_0_DSBQAF_-1_0_DSBQAF_1_1_BMAF_0_-1_BMAF_0_-1_BMAF_0_-1_BMAF_0_APBRAF_0_-1_BMA
350,91,91,15,822,0,-822,0,0
351,273,273,18,822,0,-822,0,EY_9_AA_9_AA_1_BMAFAA_2_AA_9_AA_3_AA_9_AA_4_AW_13_AC_5_AA_9_AA_6_AA_9_AA_7_AA_9_AA_8_AA_9_AA_1_ADFA_1_1_APBIDDDMADFBBMFCBRAFAD_1_BRAPBRBRAFADFD_-1_1_APBRAFAPBRFE_1_-1_BMAFAP_0_ADFFBMEOAFBMADFG_0_-1_ADFH_-1_-1_APBRBMADFIEU_4_DLED_-1_0_DSBQAF_-1_0_DSBQAF_1_1_BMAF_0_-1_BMAF_0_-1_BMAF_0_-1_BMAF_0_APBRAF_0_-1_AA_9
352,338,338,18,822,0,-822,0,EY_9_AA_9_AA_1_BMAFAA_2_AA_9_AA_3_AA_9_AA_4_AW_13_AC_5_AA_9_AA_6_AA_9_AA_7_AA_9_AA_8_AA_9_AA_1_ADFA_1_1_APBIDDDMADFB_-1_-1_BMADAF_0_-1_BMADAFBMFCBRAFAD_1_BRAPBRBRAFADFD_-1_1_APBRAFAPBRFE_1_-1_BMAFAP_0_ADFF_0_1_BMAFBMADFG_0_-1_ADFH_-1_-1_APBRAFBMADFIEU_4_DLED_-1_0_DSBQAF_-1_0_DSBQAF_1_1_BMAF_0_-1_BMAF_0_-1_BMAF_0_-1_BMAF_0_APBRAF_0_-1_AA_9
353,222,222,11,823,0,-823,0,1
354,342,342,15,825,854,29,0,1
355,341,341,15,825,826,1,0,EY_9_AA_9_AA_1_AA_9_AA_2_AA_9_AA_3_AA_9_AA_4_AA_9_AA_5_AA_9_AA_6_AA_9_AA_7_AA_9_AA_8_AA_9_AA_1_ADFA_1_1_APBRAFBMADFB_-1_0_-1_BMAFBMADFC_-1_BMADFD_1_BRAPBRAFBMADFE_1_AP_0_AFBM_-1_AP_0_AFBMADFF_0_1_APBRAFBMADFGFH_-1_-1_APEQAFBMADFIEU_4_DLED_-1_0_DSBQAF_-1_0_DSBQAF_1_1_BMAF_0_-1_BMAF_0_-1_BMAF_0_-1_BMAF_0_APBRAF_0_-1_BMA
356,340,340,15,825,934,109,0,EY_9_AA_9_AA_1_AA_9_AA_2_AA_9_AA_3_AA_9_AA_4_AA_9_AA_5_AA_9_AA_6_AA_9_AA_7_AA_9_AA_8_AA_9_AA_1_ADFA_1_APBR_1_APBRAFBMADFB_-1_0_-1_BMAFBMADFC_-1_1_APBRAFBMADFD_1_BRAFBMAPBRAFBMADFE_0_AN_-5_DFEM_1_APBRAFBMADFF_0_-1_-1_FG_-1_-1_APEQAFBMADFHEU_4_DLED_-1_0_DSBQAF_-1_0_DSBQAF_1_1_BMAF_0_-1_BMAF_0_-1_BMAF_0_-1_BMAF_0_APBRAF_0_-1_BMA
357,345,345,16,826,0,-826,0,EY_9_AA_9_AA_1_AA_9_AA_2_AA_9_AA_3_AA_9_AA_4_AA_9_AA_5_AA_9_AA_6_AA_9_AA_7_AA_9_AA_8_AA_9_AA_1_ADFA_1_1_APBRAFBMADFB_-1_0_-1_BMAFBMADFC_-1_1_APBRAFBMADFD_1_BRAFBMAPBRAFBMADFE_1_AP_0_AFBM_-1_AP_0_AFBMADFF_0_1_APBRAFBMADFG_0_2_FH_-1_-1_APEQAFBMADFIEU_4_DLED_-1_0_DSBQAF_-1_0_DSBQAF_1_1_BMAF_0_-1_BMAF_0_-1_BMAF_0_-1_BMAF_0_APBRAF_0_-1_BMA
358,343,343,10,826,841,15,0,5
359,241,241,12,831,917,86,0,EY_9_AA_9_AA_1_AA_9_AA_2_AA_9_AA_3_AA_9_AA_4_AA_9_AA_5_AA_9_AA_6_AA_9_AA_7_AA_9_AA_8_AA_9_AA_1_ADFA_1_1_APBRAFBMADFB_-1_1_-1_BMAFBMADFC_-1_1_APBRADFD_1_BRAPBRAFBMADFE_0_-1_AP_42_DBDZ_97_0_AFBMADFF_0_1_APBRAFBMADFG_-1_-1_APBRAFBMADFHEU_4_DLED_-1_0_DSBQAF_54_77_-1_0_DSBQAF_1_1_BMAF_0_-1_BMAFAF_0_-1_BMAF_0_APBRAF_0_-1_BMA
360,211,211,8,832,0,-832,0,EY_9_AA_9_AA_1_AA_9_AA_2_AA_9_AA_3_AA_9_AA_4_AA_9_AA_5_AAAA_9_AA_7_AA_9_AA_8_AA_9_AA_1_ADFAAD_1_EQEXEXBM_1_FB_-1_0_APAFAFBMADFC_-1_1_1_-1_APBRADFD_1_0_APBRAFBMADFEAPBRAFBMADFF_0_1_APBKAFBMADFG_0_-1_APBRAFBMADFH_-1_-1_APBRAFBMADFIEU_4_DLED_-1_0_DSBQAF_-1_0_DSBQAF_1_1_BMAF_0_-1_BMAF_0_-1_BMAF_0_-1_BMAF_0_-1_BMAF_0_-1_BMA
361,282,282,19,832,0,-832,0,EY_9_AA_9_AA_1_BMAFAA_2_AA_9_AA_3_AA_9_AA_4_AW_13_AC_5_AA_9_AA_6_AADTEJ_9_AA_7_AA_9_AA_8_AA_9_AA_1_ADFA_1_1_APBIDDDMADFB_-1_0_-1_BMADAFBMFCBRAFAD_1_BRAPBRBRAFADFD_-1_1_APBRAFAPBRFE_1_-1_BMAFAP_0_ADFF_0_1_BMAFBMADFGADFH_-1_-1_APBRAFBMADFIEU_4_DLED_-1_0_DSBQAF_-1_0_DSBQAF_1_1_BMAF_0_-1_BMAF_0_-1_BMAF_0_-1_BMAF_0_APBRAF_0_-1_AA_9
362,188,285,19,832,856,24,97,EY_9_AA_9_AA_1_BMAFAA_2_AA_9_AA_3_AA_9_AA_4_AA_9_AA_5_AA_9_AA_6_AA_9_AA_7_AA_9_AA_8_AA_9_AA_1_ADFA_1_1_APBIDDDMADFB_-1_BMADAFBMFCBRAFAD_1_BRBRAFADFD_-1_1_APBRAFAPBRFE_1_-1_BMAFAP_0_ADFF_0_1_BMADFG_0_-1_ADFH_-1_-1_APBRAFBMADFIEU_4_DLED_-1_0_DSBQAF_-1_0_DSBQAF_1_1_BMAF_0_-1_BMAF_0_-1_BMAF_0_-1_BMAF_0_APBRAF_0_-1_AA_9
363,257,257,9,834,0,-834,0,EY_9_AA_9_AA_1_AA_9_AA_9_AA_3_AA_9_AA_4_AA_9_AA_5_AA_9_AA_6_AA_9_AA_7_AA_9_AA_8_AA_9_AA_1_ADFABRAFBMAD_1_1_APBRAFBMADFBEF_-7_ER_-1_0_APBRAFBMADFC_-1_1_APBRBRAFBMAFBMADFD_1_0_APBRAFBMAD_-59_13_FE_1_-1_APBRAFBMADAPBRAFFF_0_1_APBRAFBMADFG_0_-1_ADFH_-1_-1_APBR_-1_APBRAFBMADFIEU_4_DLED_-1_0_DSBQAF_-1_0_DSBQAF_1_1_BMAF_0_-1_BMAF_0_-1_BMAF_0_-1_BMAF_0_APBRAF_0_-1_BMA
364,59,59,13,837,0,-837,0,EY_9_AA_9_AA_1_BMAFAA_2_AA_9_AA_3_AA_9_AA_4_AA_9_AA_5_AA_9_AA_6_AA_9_AA_7_AA_9_AA_8_AA_9_AA_1_ADFA_1_1_-1_BIDDDMADFB_-1_0_-1_AP_0_AFBMFC_-1_1_APBRAFAPBRFD_1_-1_BMAFBMADADFE_0_1_BMADAFBMADFF_0_-1_ADFGAP_-1_APBRAFBMADFHEU_4_DLED_-1_0_DSBQAF_-1_0_DSBQAF_1_1_BMAF_0_-1_BMAF_0_-1_BMAF_0_-1_BMAF_0_APBRAF_0_-1_AA_9
365,117,117,9,837,0,-837,0,EY_9_AA_9_AA_1_AA_9_AA_2_AA_9_AA_3_AA_9_AA_4_AA_9_AA_5_AA_9_AA_6_AA_9_AAAA_9_AA_8_AA_9_AA_1_ADFA_1_1_APAFBMBMADFB_-1_0_-1_BMAFBMADFCAFBMADFD_1_BRAPBRBRAFADFE_1_-1_AP_0_FF_0_1_APBRAFBMADFG_0_-1_APBRADFH_1_3_APBRAFBMADFIEU_4_DLED_-1_0_DSBQAF_-1_0_DSBQAF_1_1_BMAF_0_-1_BMAF_0_-1_BMAF_0_-1_BMAF_0_APBR_0_-1_BMA
366,357,357,17,841,0,-841,0,EY_9_AA_9_AA_1_AA_9_AA_2_AA_9_AA_3_AA_9_AA_4_AA_9_AA_5_AA_9_AA_6_AA_9_AA_7_AA_9_AA_8_AA_9_AA_1_ADFA_1_BRAFBMADFBBMAF_-1_BMAFBMADFC_-1_1_APBRAFBMADFD_1_BRAFBMAPBRAFBMADFE_1_AP_0_AFBM_-1_AP_0_AFBMADFF_0_1_APBRAFBMADFG_0_2_FH_-1_-1_APEQAFBMADFIEU_4_DLED_-1_0_DSBQAF_-1_0_DSBQAF_1_1_BMAF_0_-1_-1_0_0_-1_BMAF_0_-1_BMAF_0_APBRAF_0_-1_BMA
367,322,322,13,843,843,0,0,EY_9_AA_9_AA_1_AA_9_AA_2_AA_9_AA_3_AA_9_AA_4_AA_9_AA_5_AA_9_AA_6_AA_9_AA_7_AA_9_AA_8_AA_9_AA_1_ADFA_1_1_APBRAFBMADFB_-1_0_-1_BMAFBMADFC_-1_1_APBRAFBMADFDBRAPBRFE_1_-1_APBRAFBMADAFFF_0_1_APBRAFBMADFG_0_-1_APBRAFBMADFH_-1_-1_APBRAFBMADFIEU_4_DLED_-1_0_DSBQAF_-1_0_DSBQAF_1_1_BMAF_0_-1_BMAF_0_-1_BMAF_0_-1_BMAF_0_APBRAF_0_-1_BMA
368,109,109,14,844,0,-844,0,4
369,199,199,17,848,0,-848,0,EY_9_AA_9_AA_1_BMAFAA_2_AA_9_AA_3_AA_9_AA_4_AW_13_AC_5_AA_9_AA_6_AA_9_AA_7_AA_9_AA_8_AA_9_AA_1_ADFA_1_1_APBIDDDMADFB_-1_0_-1_BMADAFBMFC_-1_1_APBRAFAPBRFD_1_-1_AB_-38_BMAFAP_0_ADFE_0_1_BMAFBMADFF_0_-1_ADFG_-1_-1_APBRAFBMADFHEU_4_DLED_-1_0_DSBQAF_-1_0_DSBQAF_1_1_BMAF_0_-1_BMAF_0_-1_BMAF_0_-1_BMAF_0_APBRAF_0_-1_AA_9
370,323,323,13,848,0,-848,0,EY_9_AA_9_AA_1_AA_9_AA_2_AA_9_AA_3_AA_9_AA_4_AA_9_AA_5_AA_9_AA_6_AA_9_AA_7_AA_9_AA_8_AA_9_AA_1_ADFA_1_1_APBRAFBMADFB_-1_0_-1_BM_0_-1_BMAFBMADFC_-1_APBRAFADFD_1_FE_-1_APBR_0_AFADFF_0_1_-26_AJAPBRADFG_0_-1_1_APBRBMADFH_-1_1_-1_APAFBMADFIEU_4_DLED_-1_0_DSBQAF_54_77_-1_0_DSBQAF_1_1_BMAF_0_-1_BMAF_0_-1_BMAF_0_-1_BMAF_0_APBRAF_0_-1_BMA
371,326,326,17,851,0,-851,0,EY_9_AA_9_AA_1_BMAFAA_2_AA_9_AA_3_AA_9_AA_4_AW_13_AC_5_AA_9_AA_6_AA_9_AA_7_AA_9_AA_8_AA_9_AA_1_ADFA_1_1_APBIDDDMADFB_-1_0_-1_BMADAFBMFCBRAFAD_1_BRAPBRBRAFADFD_-1_1_APBRAFAPBRFE_1_-1_BMAFAP_0_ADFF_0_1_BMEOAFBMADFG_0_-1_AD_0_-1_ADFH_-1_-1_APBRAFBMADFIEU_4_DLED_-1_0_DSBQAF_-1_0_DSBQAF_1_-49_-81_AK_1_BMAF_0_-1_BMAF_0_-1_BMAF_0_-1_BMAF_0_APBRAF_0_-1_AA_9
372,73,73,2,854,0,-854,0,EY_9_AA_9_AA_1_AA_9_AA_2_AA_9_AA_3_AA_9_AA_4_AA_9_AA_5_AA_9_AA_6_AA_9_AA_7_AA_9_AA_8_AA_9_AA_1_ADFA_1_1_APBRAFBMADFB_-1_0_APBRAFBMADFC_-1_1_APBRAFBMADFD_1_0_APBRAFBMADFE_1_-1_APBRAFBMADFF_0_-1_APBRAFBMADFG_-1_-1_APBRAFBMADFHEU_4_DLED_-1_0_DSBQAF_-1_0_DSBQAF_1_1_BMAF_0_-1_BMAF_0_-1_BMAF_0_-1_BMAF_0_-1_BMAF_0_-1_BMA
373,292,292,8,856,0,-856,0,7
374,366,366,18,856,0,-856,0,EY_9_AA_9_AA_1_AA_9_AA_2_AA_9_AA_3_AA_9_AA_4_AA_9_AA_5_AA_9_AA_6_AA_9_AA_7_AA_9_AA_8_AA_9_AA_1_ADFA_1_BRAFBMADFBBMAF_-1_BMAFBMADFC_-1_1_APBRAFBMADFD_1_BRAFBMAFBMAPBRAFBMADFE_1_AP_0_AFBM_-1_AP_0_AFBMADFF_0_1_APBMADFG_0_2_FH_-1_-1_APEQAFBMADFIEU_4_DLED_-1_0_DSBQAF_-1_0_DSBQAF_1_1_BMAF_0_-1_-1_0_0_-1_BMAF_0_-1_BMAF_0_APBRAF_0_-1_BMA
375,368,368,15,859,0,-859,0,4
376,336,336,9,861,873,12,0,EY_9_AA_9_AA_1_AA_9_AA_2_AA_9_AA_3_AA_9_AA_4_AA_9_AA_5_AA_9_AA_6_AA_9_AA_7_AA_9_AA_8_AA_9_AA_1_ADFA_1_1_APBRAFBMADFB_-1_0_APBRAFBMADFC_-1_1_APBRAFBMADFD_1_BRAFBMAD_0_APFE_1_BMADFF_0_APBRAFBMADFG_0_-1_APBRAFBMADFH_-1_-1_APBRAFBMADFIEU_4_DLED_-1_0_DSBQAF_-1_0_DSBQAF_1_1_BMAF_0_-1_BMAF_0_-1_BMAF_0_-1_BMAF_0_-1_BMAF_-1_0_EBB
377,341,341,15,866,912,46,0,EY_9_AA_9_AA_1_AA_9_AA_2_AA_9_AA_3_AA_9_AA_4_AA_9_AA_5_AA_9_AA_6_AA_9_AA_7_AA_9_AA_8_AA_9_AA_1_ADFA_1_1_APBRAFBMADFB_-1_0_-1_BMAFBMADFC_-1_1_APBRAFBMADFD_1_BRAPBRAFBMADFE_1_AP_0_AFBM_-1_AP_0_AFBMADFF_0_1_APBRAFBMADFGFH_-1_-1_APEQAFBMADFIEU_4_DLED_-1_0_DSBQAF_-1_0_DSBQAF_1_1_BMAF_0_-1_BMAF_0_-1_BMAF_0_-1_BMAF_0_APBRAF_0_-1_BMA
378,245,245,18,867,871,4,0,EY_9_AA_9_AA_1_BMAFAA_2_AA_9_AA_3_AA_9_AA_4_AW_13_AC_5_AA_9_AA_6_AA_9_AA_7_AA_9_AA_8_AA_9_AA_1_ADFA_1_1_APBIDDDMADFB_-1_0_-4_AZADAFBMFC_-1_1_APBRAFAPBRFD_1_-1_BMAFAP_0_ADFE_0_1_BMEOAFBMADFF_0_-1_ADFG_-1_-1_APBRAFBMADFHEU_4_DLED_-1_0_DSBQAF_-1_0_DSBQAF_1_1_BMAF_0_-1_BMAF_0_-1_BMAF_0_-1_BMAF_0_APBRAF_0_-1_AA_9
379,345,345,16,867,872,5,0,EY_9_AA_9_AA_1_AA_9_AA_2_AA_9_AA_3_AA_9_AA_4_AA_9_AA_5_AA_9_AA_6_AA_9_AA_7_AA_9_AA_8_AA_9_AA_1_ADFA_1_1_APBRAFBMADFB_-1_0_-1_BMAFBMADFC_-1_1_APBRAFBMADFD_1_BRAFBMAPBRAFBMADFE_1_AP_0_AFBM_-1_AP_0_AFBMADFF_0_1_APBRAFBMADFG_0_-1_FH_-1_-1_APEQAFBMADFIEU_4_DLED_-1_0_DSBQAF_-1_0_DSBQAF_1_1_BMAF_0_-1_BMAF_0_-1_BMAF_0_-1_BMAF_0_APBRAF_0_-1_BMA
380,343,343,10,867,870,3,0,EY_9_AA_9_AA_1_AA_9_AABS_29_2_AA_9_AA_3_AA_9_AA_4_AA_9_AA_5_AA_9_AA_6_AA_9_AA_7_AA_9_AA_8_AA_9_AA_1_ADFA_1_1_APBRAFBMAD_-86_65_6_FBADFC_1_BRAPBRAFBMADFD_1_-1_AP_0_AFBMADFE_0_1_APBRAFBMADFF_0_-1_APBRAFBMADFG_-1_-1_APBRAFBMADFHEU_4_DLED_-1_0_DSBQAF_-1_0_DSBQAF_1_1_BMAF_0_-1_BMAF_0_-1_BMAF_0_-1_BMAF_0_APBRAF_0_-1_BMA
381,375,375,16,874,1009,135,0,EY_9_AA_9_AA_1_AABMAD_2_AA_9_AA_3_AA_9_AA_4_AA_9_AA_5_AA_6_AA_9_AA_7_AA_9_AA_8_AA_9_AA_1_ADFA_1_1_APBRAFBMADFB_-1_0_-1_BMAF_9_AAFC_-1_1_APBRAFBMADFD_1_BRBMADAFBMADFE_1_AP_0_AFBM_-1_AP_0_AFBMADFF_0_1_APBRAFAPBRFG_0_-1_APFH_-1_-1_APEQAFBMADFIEU_4_DLED_-1_0_DSBQAF_-1_0_DSBQAF_1_1_BMAF_0_-1_BMAF_0_-1_BMAF_0_-1_BMAF_0_APBRAF_0_-1_BMA
382,251,251,19,877,0,-877,0,EY_9_AA_9_AA_1_BMAFAA_2_AA_9_AA_3_AA_9_AA_4_AW_13_AC_5_AA_9_AA_6_AADTEJ_9_AA_7_AA_9_AA_8_AA_9_AA_1_ADFA_1_1_APBIDDDMADFB_-1_0_-1_BMADAFBMFCBRAFAD_1_BRAPBRBRAFADFD_-1_1_APBRAFAPBRFE_1_-1_BMAFAP_0_ADFF_0_1_ADBMAFBMADFG_0_0_ADFH_-1_-1_APBRAFBMADFIEU_4_DLED_-1_0_DSBQAF_-1_0_DSBQAF_1_1_BMAF_0_-1_BMAF_0_-1_BMAF_0_-1_BMAF_0_APBRAF_0_-1_AA_9
383,276,276,10,882,913,31,0,16
384,317,317,19,882,0,-882,0,EY_9_AA_9_AA_1_BMAFAA_2_AA_9_AA_3_AA_9_AA_4_AW_13_AC_5_AA_9_AA_6_AA_9_AA_7_AA_9_AA_8_AA_9_AA_1_ADFA_1_1_APBIDDDMADFB_-1_0_-1_BMADAFBMFCBRAFAD_1_BRAPBRBRAFADFD_-1_1_APBRBRAFAPBRFE_1_-1_BMAFAP_0_ADFF_0_1_BMEOAFBMADFG_0_-1_ADFH_-1_-1_APBRAFBMADFIEU_4_DLED_-1_0_DSBQAF_-1_0_DSBQAF_1_1_BMAF_0_-1_BMAF_0_-1_BMAF_0_-1_BMAF_0_APBRAF_0_-1_AA_9
385,357,357,17,882,0,-882,0,EY_9_AA_9_AA_1_AA_9_AA_2_AA_9_AA_3_AA_9_AA_4_AA_9_AA_5_AA_9_AA_6_AA_9_AA_7_AA_9_AA_8_AA_9_AA_1_ADFA_1_1_APBRAFBMADFB_-1_0_-1_BMAFBMADFC_-1_1_APBRAFBMADFD_1_BRAFBMAPBRAFBMADFE_1_AP_0_AFBM_-1_AP_0_AFBMADFF_0_1_APBRAFBMADFG_0_2_FH_-1_-1_APEQAFBMADFIEU_4_DLED_-1_0_DSBQAF_-1_0_DSBQAF_1_1_BMAF_0_-1_BMAF_0_-1_BMAF_0_-1_BMAF_0_APBRAF_0_-1_BMA
386,111,111,17,883,1000,117,0,EY_9_AA_9_AA_1_AA_9_AA_2_AA_9_AA_3_AA_9_AA_4_AA_9_AA_5_AA_9_AA_6_AA_9_AA_7_AA_9_AA_8_AAFA_1_1_APBRAFBMADFB_-1_0_-1_BMAFBMADFC_-1_1_ADFD_1_BRAFBMAPBRAFBMADFE_1_AP_0_AFBM_-1_AP_0_AFBMADFF_0_1_APBRAFBMADFG_0_-1_-1_FH_-1_-1_APEQAFBMADFIEU_4_DLED_-1_0_DSBQAF_-1_0_DSBQAF_1_1_BMAF_0_-1_BMAF_0_-1_BMAF_0_-1_BMAF_0_APBRAF_0_-1_BMA
387,381,381,17,889,0,-889,0,EY_9_AA_9_AA_1_AABMAD_2_AA_9_AA_3_AA_9_AA_4_AA_9_AA_5_AA_6_AA_9_AA_7_AA_9_AA_8_AA_9_AA_1_ADFA_1_1_APBRAFBMADFB_-1_0_-1_BMAF_9_AAFC_-1_1_APBRAFBMADFD_1_BRBMADAFBMADFE_1_AP_0_AFBM_-1_AP_0_AFBMADFF_0_1_APBRAFAPBRFG_0_-1_APFH_-1_-1_APEQAFBMADFIEU_4_DLED_-1_0_DSBQAF_-1_0_DSBQAF_1_1_BMAF_0_-1_BMAF_0_-1_BMAF_0_-1_BMAF_0_APBRAF_0_-1_BMA
388,199,199,17,893,0,-893,0,EY_9_AA_9_AA_1_BMAFAA_2_AA_9_AA_3_AA_9_AA_4_AW_13_AC_5_AA_9_AA_6_AA_9_AA_7_AA_9_AA_8_AA_9_AA_1_ADFA_1_1_APBIDDDMADFB_-1_0_-1_BMADAFBMFCBRAFAD_1_BRAPBRBRAFADFD_-1_1_APBRFE_1_-1_BMAFAP_0_ADFF_0_1_BMAFBMADFG_0_-1_ADFH_-1_-1_APBRAFBMADFIEU_4_DLED_-1_0_DSBQAF_-1_0_DSBQAF_1_1_BMAF_0_-1_BMAF_0_-1_BMAF_0_-1_BMAF_0_APBRAF_0_-1_AA_9
389,320,320,16,895,0,-895,0,EY_9_AA_9_AA_1_AA_9_AA_2_AA_9_AA_3_AA_9_AA_4_AA_9_AA_5_AA_9_AA_6_AA_9_AA_7_AA_9_AA_8_AA_9_AA_1_ADFA_1_92_-6_EJDD_1_AP_-6_BRAFBMADFB_-1_0_-1_BMAFBMADFC_1_4_AYFD_1_BRAPBRAFBMADFE_1_-1_AP_0_AFBMADFF_0_FG_0_-1_APFH_-1_-1_APBR_-1_0_DSFIEU_6_DLED_-4_-2_DSBQAF_-4_-2_DSBQAF_4_-3_BMAF_2_1_BMAF_-1_2_BQBMAF_3_3_BMAF_4_APBRAF_2_-5_BMA
390,331,331,20,897,0,-897,0,EY_1_1_APBIDDDMADFA_-1_0_1_EKDVAFBMFBBRAFAD_1_BRAPBRBRAFADFC_-1_-2_ALENAOAPBRFD_1_-1_BMAFAP_0_ADFE_0_1_BMEOAFBMADFF_0_-1_ADFG_-1_-1_APBRAFBMADFHEU_4_DLED_-1_0_DSBQAF_-1_0_DSBQAF_1_1_BMAF_0_-1_BMAF_0_-1_BMAF_0_-1_BMAF_0_APBRAF_0_-1_AA_9
391,386,386,18,898,0,-898,0,EY_9_AA_9_AA_1_AA_9_AA_2_AA_9_AA_3_AA_9_AA_4_AA_9_AA_5_AA_9_AA_6_AA_9_AA_7_AA_9_AA_8_AAFA_1_1_APBRAFBMADFB_-1_0_-1_BMAFBMADFC_-1_1_ADFD_1_BRAFBMAPBRAFBMADFE_1_AP_0_AFBM_-1_AP_0_AFBMADFF_0_1_APBRAFBMADFG_0_-1_-1_FH_-1_-1_APEQAFBMADFIEU_4_DLED_-1_0_DSBQAF_-1_0_DSBQAF_1_1_BMAF_0_-1_BMAF_0_-1_BMAF_0_-1_BMAF_0_APBRAF_0_-1_BMA
392,126,126,19,899,0,-899,0,EY_9_AA_9_AA_1_AA_9_AA_2_AA_9_AA_3_AA_9_AA_4_AA_9_AA_5_AA_9_AA_6_AA_9_AA_7_AA_9_AA_8_AAFA_1_1_APBRAFBMADFB_-1_0_-1_BMAFBMADFC_-1_1_APBRAFBMADFD_1_BRAFAFBMADFE_1_AP_0_AFBM_-1_AP_0_AFBMADFF_0_1_APBRAFBMADFG_0_-1_-1_FH_-1_-1_APEQAFBMADFIEU_4_DLED_-1_0_DSBQAF_-1_0_DSBQAF_1_1_BMAF_0_-1_BMAF_0_-1_BMAF_0_-1_BMAF_0_APBRAF_0_-1_BMA
393,136,136,15,900,0,-900,0,9
394,368,368,15,900,0,-900,0,4
395,291,280,12,904,0,-904,-11,EY_9_AA_9_1_AA_9_AA_2_AA_9_AA_3_AA_9_AA_4_AA_9_AA_5_AA_9_AAAA_7_AA_9_AA_8_AA_9_AA_1_ADFA_1_1_APBRAFBMADFB_-1_0_-1_BMAFBMADFC_-1_APBRAFADFD_1_0_APBRAFBMADFE_-1_APBR_0_AFBMADFF_0_-26_AJAPBRAFBMADFG_0_-1_1_APBRBMADFH_-1_1_-1_APAFBMA
396,387,387,18,904,0,-904,0,EY_9_AA_9_AA_1_AABMAD_2_AA_9_AA_3_AA_9_AA_4_AA_9_AA_5_AA_6_AA_9_AA_7_AA_9_AA_8_AA_9_AA_1_ADFA_1_1_APBRAFBMADFB_-1_0_-1_BMAF_9_AAFC_-1_1_APBRAFBMADFD_1_AP_0_AFBM_-1_AP_0_AFBMADFE_0_1_APBRAFAPBRFF_0_-1_APFG_-1_-1_APEQAFBMADFHEU_4_DLED_-1_0_DSBQAF_-1_0_DSBQAF_1_1_BMAF_0_-1_BMAF_0_-1_BMAF_0_-1_BMAF_0_APBRAF_0_-1_BMA
397,145,145,16,908,0,-908,0,9
398,270,270,12,908,0,-908,0,EY_9_AA_9_AA_1_AA_9_AA_2_AA_9_AA_3_AA_9_AA_4_AA_9_AA_5_AA_9_AA_6_AA_9_AA_7_AA_9_AA_8_AA_9_AA_1_ADFA_1_1_APBRAFBMADFB_-1_0_-1_BMAFBMADFC_-1_1_APBRADFD_1_BRAPBRAFBMADFE_1_-1_AP_42_DBDZ_97_0_AFBMADFF_0_1_APBRAFBMADFG_0_APBRAFBMADFH_-1_-1_APBRAFBMADFIEU_4_DLED_-1_0_DSBQAF_54_77_-1_0_DSBQAF_1_1_BMAF_0_-1_BMAF_0_-1_BMAF_0_-1_BMAF_0_APBRAF_0_-1_BMA
399,301,301,11,911,942,31,0,EY_9_AA_9_AA_1_AA_9_AA_2_AA_9_AA_3_AA_9_AA_4_AA_9_AA_5_AA_9_AAAA_7_AA_9_AA_8_AA_9_AA_1_ADFA_1_1_APBRAFBMADFB_-1_0_-1_BMAFBMADFC_-1_1_APBRAFBMADFD_1_APBRAFBM_0_APBRAFBMADFE_1_-1_APBRAFBMADAFFF_0_1_APDSAKBMADFG_0_-1_APBRAFADFH_-1_-1_AP_33_-10_BRAFBMADFIEU_4_DLED_-1_0_DSBQAF_-1_0_DSBQAF_1_1_BMAF_0_-1_BMAF_0_-1_BMAF_0_-1_BMAF_0_APBRAF_0_-1_BMA
400,373,373,9,912,0,-912,0,7
401,391,391,19,913,0,-913,0,EY_9_AA_9_AA_1_AA_9_AA_2_AA_9_AA_3_AA_9_AA_4_AA_9_AA_5_AA_9_AA_6_AA_9_AA_7_AA_9_AA_8_AAFA_1_1_APBRAFBMADFB_-1_0_-1_BMAFBMADFC_-1_1_ADFD_1_BRAFBMAPBRAFBMADFE_1_AP_0_AFBM_-1_AP_0_AFBMADFF_0_1_APDGAHBRAFBMADFG_0_-1_-1_FH_-1_-1_AFBMADFIEU_4_DLED_-1_0_DSBQAF_-1_0_DSBQAF_1_1_BMAF_0_-1_BMAF_0_-1_BMAF_0_-1_BMAF_0_APBRAF_0
402,322,322,13,915,931,16,0,EY_9_AA_9_AA_1_AA_9_AA_2_AA_9_AA_3_AA_9_AA_4_AA_9_AA_5_AA_9_AA_6_AA_9_AA_7_AA_9_AA_8_AA_9_AA_1_ADFA_1_1_APBRAFBMADFBEU_4_DLED_-1_0_DSBQAF_-1_0_DSBQAF_1_1_BMAF_0_-1_BMAF_0_-1_BMAF_0_-1_BMAF_0_APBRAF_0_-1_BMAFFC_-1_1_APBRAFBMADFDBRAPBRAFBMADFE_1_-1_APBRAFBMADAFFF_0_1_APBRAFBMADFG_0_-1_APBRAFBMADFH_-1_-1_APBRAFBMADFI_-1_0_0_ASDYBMA
403,393,393,16,915,0,-915,0,EY_9_AA_9_AA_1_AA_9_AA_2_AA_9_AA_3_AA_9_AA_4_AA_9_AA_5_AA_9_AA_6_AA_9_AA_7_AA_9_AA_8_AA_9_AA_1_ADFABRAFBMADFB_-1_0_-1_BMAFBMADFC_-1_1_APBRAFBMADFD_1_BRAPBRAFBMADFE_1_AP_0_AFBM_-1_AP_0_AFBMADFF_1_APBRAF_0_1_APBRAFBMADFG_0_-1_APFH_-1_-1_APEQAFBMADFIEU_4_DLED_-1_0_DSBQAF_-1_0_DSBQAF_1_1_BMAF_0_-1_BMAF_0_-1_BMAF_0_-1_BMAF_0_APBRAF_0_-1_BMA
404,336,336,9,919,945,26,0,EY_9_AA_9_AA_1_AA_9_AA_2_AA_9_AA_3_AA_9_AA_4_AA_9_AA_5_AA_9_AA_6_AA_9_AA_7_AA_9_AA_8_AA_9_AA_1_ADFA_1_1_APBRAFBMADFB_-1_0_APBRAFBMADFC_-1_1_APBRAFBMADFD_1_0_APBRAFBMADFE_1_BMADFF_0_APBRAFBMADFG_0_-1_APBRAFBMADFH_-1_-1_APBRAFBMADFIEU_8_DLED_2_-1_DSBQAF_-4_2_DSBQAF_-2_2_BMAF_-2_-4_BMAF_-4_-3_BMAF_4_2_BMAF_2_-3_BMAF_1_3_BMA
405,333,333,13,922,0,-922,0,1
406,348,348,14,923,0,-923,0,4
407,350,350,16,923,0,-923,0,0
408,343,343,10,925,0,-925,0,EY_9_AA_9_AA_1_AA_9_AABS_29_2_AA_9_AA_3_AA_9_AA_4_AA_9_AA_5_AA_9_AA_6_AA_9_AA_7_AA_9_AA_8_AA_9_AA_1_ADFA_1_1_APBRAFBMADFB_-1_0_-1_BMAFBMADFCBRFD_1_BRAPBRAFBMADFE_1_-1_AP_0_AFBMADFF_0_1_APADAFBMADFG_0_-1_APBRAFBMADFH_-1_-1_APBRAFBMADFIEU_4_DLED_-1_0_DSBQAF_-1_0_DSBQAF_1_1_BMAF_0_-1_BMAF_0_-1_BMAF_0_-1_BMAF_0_APBRAF_0_-1_BMA
409,398,398,13,925,946,21,0,EY_9_AA_9_AA_1_AA_9_AA_2_AA_9_AA_3_AA_9_AA_4_AA_9_AA_5_AA_9_AA_6_AA_9_AA_7_AA_9_AA_8_AA_9_AA_1_ADFA_1_1_APBRAFBMADFB_-1_0_-1_BMAFBMADFC_-1_1_APBRADFD_1_BRAPBRAFBMADFE_1_-1_AP_42_DBDZ_97_0_AFBMADFFEJ_0_1_APBRAFBMADFG_0_APBRAFBMADFH_-1_-1_APBRAFBMADFIEU_4_DLED_-1_0_DSBQAF_54_77_-1_0_DSBQAF_1_1_BMAF_0_-1_BMAF_0_-1_BMAF_0_-1_BMAF_0_APBRAF_0_-1_BMA
410,399,399,12,926,1002,76,0,EY_9_AA_9_AA_1_AA_9_AA_2_AA_9_AA_3_AA_9_AA_4_AA_9_AA_5_AA_9_AAAA_7_AA_9_AA_8_AA_9_AA_1_ADFA_1_1_APBRAFBMADFB_-1_0_-1_BMAFBMADFC_-1_1_APBRAFBMADFD_1_APBRAFBM_0_APBRAFBMADFE_1_-1_APBRAFBMADAFFF_0_1_APDSAKBMADFG_0_-1_APBRAFADFH_-1_-1_AP_33_-10_BRAFBMADFIEU_4_DLED_-1_0_DSBQAF_-1_0_DSBQAF_1_1_BMAF_0_-1_BMAF_0_-1_BMAF_0_-1_BMAF_0_APBRAF_0_-1_BMA
411,131,334,17,927,970,43,203,EY_9_AA_9_AA_1_AA_9_AA_2_AA_9_AA_3_AA_9_AA_4_AA_9_AA_5_AA_9_AA_6_AA_9_AA_7_AA_9_AA_8_AA_9_AA_1_ADFA_1_92_-6_EJDD_1_AP_-6_BRAFBMADFB_-1_0_-1_BMAFBMADFC_-1_1_APBRAFBMADFD_2_BRAPBRAFBMADFE_1_AP_0_AFBM_-1_AP_0_AFBMADFF_0_FG_0_-1_APFH_-1_BQBU_-83_-1_APEQAFBMADFIEU_6_DLED_-4_-2_DSBQAF_-4_-2_DSBQAF_4_-3_BMAF_2_1_BMAF_-1_2_BQBMAF_3_3_BMAF_4_APBRAF_2_-5_BMA
412,400,400,10,927,957,30,0,7
413,290,290,13,928,974,46,0,EY_9_AA_9_AA_1_AA_9_AA_2_AA_9_AA_3_AA_9_AA_4_AA_9_AA_5_AA_9_AA_6_AA_9_AA_7_AA_9_AA_8_AA_9_AA_1_ADFA_1_1_APBRAFBMADFB_-1_0_-1_BM_0_-1_BMAFBMADFC_-1_APBRAFADFD_1_BMADFE_-4_APBR_2_AFBMADFF_0_1_-26_AJAPBRAFBMADFG_-1_1_-1_APAFBMADFHEU_4_DLED_-1_0_DSBQAF_54_77_-1_0_DSBQAF_1_1_BMAF_0_-1_BMAF_0_-1_BMAF_0_-1_BMAF_0_APBRAF_0_-1_BMA
414,401,401,20,928,0,-928,0,EY_9_AA_9_AA_1_AA_9_AA_2_AA_9_AA_3_AA_9_AA_4_AA_9_AA_5_AA_9_AA_6_AA_9_AA_7_AA_9_AA_8_AAFA_1_1_APBRAFBMADFB_-1_0_-1_BMAFBMADFC_-1_1_ADFD_1_BRAFBMAPBRAFBMADFE_1_AP_0_AFBM_-1_AP_0_AFBMADFF_0_1_APDGAHBRAFBMADFG_0_-1_-1_FH_-1_-1_AFBMADFIEU_4_DLED_-1_0_DSBQAF_0_DSBQAF_1_1_BMAF_0_-1_BMAF_0_-1_BMAF_0_-1_BMAF_0_APBRAF_0
415,341,341,15,931,0,-931,0,EY_9_AA_9_AA_1_AA_9_AA_2_AA_9_AA_3_AA_9_AA_4_AA_9_AA_5_AA_9_AA_6_AA_9_AA_7_AA_9_AA_8_AA_9_AA_1_ADFA_1_1_APBRAFBMADFB_-1_0_-1_BMAFBMADFC_-1_1_APBRAFBMADFD_1_BRAPBRAFBMADFE_1_AP_0_AFBM_-1_AP_0_AFBMADFF_0_1_APBRADFGFH_-1_-1_APEQAFBMADFIEU_4_DLED_-1_0_DSBQAF_-1_0_DSBQAF_1_1_BMAF_0_-1_BMAF_0_-1_BMAF_0_-1_BMAF_0_APBRAF_0_-1_BMA
416,302,302,10,933,0,-933,0,EY_9_AA_9_AA_1_AA_9_AA_2_AA_9_AA_3_AA_9_AA_4_AA_9_AA_5_AA_9_AA_6_AA_9_AA_7_AA_9_AA_8_AA_9_AA_1_ADFA_1_1_APBRAFBMADFB_-1_0_BRAFBMADADFC_-1_1_APBRADFD_1_BRAPBRAFBMADFE_1_-1_EE_-4_EFBMADFF_0_1_APBRAFBMADFG_0_-1_AP_-1_BMAFBMFH_-1_-1_APBRAFBMA
417,328,406,15,933,968,35,78,EY_9_AA_9_AA_1_AA_9_AA_2_AA_9_AA_3_AA_9_AA_4_AA_9_AA_5_AA_6_AA_9_AA_7_AA_9_AA_8_AA_9_AA_1_ADFA_1_1_APBRAFBMADFB_-1_0_-1_BMAFBMADFC_-1_1_APBRAFBMADFD_1_BRBMADAFBMADFE_1_AP_0_AFBM_-1_AP_0_AFBMADFF_0_1_APBRAFBMADFG_0_-1_APFH_-1_-1_APEQAFBMADFIEU_4_DLED_-1_0_DSBQAF_-1_0_DSBQAF_1_1_BMAF_0_-1_BMAF_0_-1_BMAF_0_-1_BMAF_0_APBRAF_0_-1_BMA
418,297,297,10,934,0,-934,0,EY_9_AA_9_AA_1_AA_9_AA_9_AA_3_AA_9_AA_4_AA_9_AA_5_AA_9_AA_6_AA_9_AA_7_AA_9_AA_8_AA_9_AA_1_ADFABRAFBMAD_1_1_APBRAFBMADFBEF_-7_ER_-1_0_APBRAFBMADFC_-1_1_APBRBRAFBMADFD_1_0_APBRAFBMAD_-59_13_FE_1_-1_APBRADAFBMADAPBRAFFF_0_1_APBRAFBMADFG_0_-1_ADFH_-1_-1_APBR_-1_APBRAFBMADFIEU_4_DLED_-1_0_DSBQAF_-1_0_DSBQAF_1_1_BMAF_0_-1_BMAF_0_-1_BMAF_0_-1_BMAF_0_APBRAF_0_-1_BMA
419,292,292,8,935,0,-935,0,7
420,405,405,14,937,0,-937,0,1
421,348,411,18,937,992,55,63,EY_9_AA_9_AA_1_AA_9_AA_2_AA_9_AA_3_AA_9_AA_4_AA_9_AA_5_AA_6_AA_9_AA_7_AA_9_AA_8_AA_9_AA_1_ADFA_1_92_-6_EJDD_1_AP_-6_BRAFBMADFB_-1_0_-1_BMAFBMADFC_-1_1_APBRAFBMADFD_1_BRBMADAFBMADFE_1_AP_0_AFBM_-1_AP_0_AFBMADFF_0_FG_0_-1_APFH_-1_BQBU_-83_-1_APEQAFBMADFIEU_6_DLED_-4_-2_DSBQAF_-4_-2_DSBQAF_4_-3_BMAF_2_1_BMAF_-1_2_BQBMAF_3_3_BMAF_4_APBRAF_2_-5_BMA
422,331,331,20,938,0,-938,0,0
423,387,387,18,945,0,-945,0,EY_9_AA_9_AA_1_AABMAD_2_AA_9_AA_3_AA_9_AA_4_AA_9_AA_5_AA_6_AA_9_AA_7_AA_9_AA_8_AA_9_AA_1_ADFA_1_1_APBRAFBMADFB_-1_0_-1_BMAF_9_AAFC_-1_1_APBRAFBMADFD_1_BRBMADAFBMADFE_1_AP_0_AFBM_-1_AP_0_AFBMADFF_0_1_APBRAFAPBRFG_0_-1_APFH_-1_-1_APEQAFBMADFIEU_4_DLED_-1_0_DSBQAF_-1_0_DSBQAF_1_1_BMAF_0_-1_BMAF_0_-1_BMAF_0_-1_BMAF_0_APBRAF_0_-1_BMA
424,159,421,19,947,1000,53,262,EY_9_AA_9_AA_1_AA_9_AA_2_AA_9_AA_3_AA_9_AA_4_AA_9_AA_5_AA_9_AA_6_AA_9_AA_7_AA_9_AA_8_AA_9_AA_1_ADFA_1_1_APBRAFBMADFB_-1_0_-1_BMAFBMADFC_-1_1_APBRAFBMADFD_1_BRBMADAFBMADFE_1_-1_AP_0_AFBMADFF_0_1_APBMADFG_0_-1_APFH_-1_-1_APBR_-1_0_DSFIEU_4_DLED_-1_0_DSBQAFAFBMADBQAF_1_1_BMAF_0_-1_BMAF_0_-1_BMAF_0_-1_BMAF_0_APBRAF_0_-1_BMA
425,417,417,16,948,0,-948,0,EY_9_AA_9_AA_1_AA_9_AA_2_AA_9_AA_3_AA_9_AA_4_AA_9_AA_5_BMAF_0_-1_AA_7_AA_9_AA_8_AA_9_AA_1_ADFA_1_1_APBRAFBMADFB_-1_0_-1_BMAFBMADFC_-1_1_APBRAFBMADFD_1_BRBMADAFBMADFE_1_AP_0_AFBM_-1_AP_0_AFBMADFF_0_1_APBRAFBMADFG_0_-1_APFH_-1_-1_APADFIEU_4_DLED_-1_0_DSBQAF_-1_0_DSBQAF_1_1_AA_6_AA_9_BMAF_0_-1_BMAF_0_-1_BMAF_0_APBRAF_0_-1_BMA
426,419,419,9,950,0,-950,0,7
427,420,420,15,952,0,-952,0,1
428,391,391,19,954,0,-954,0,EY_9_AA_9_AA_1_AA_9_AA_2_AA_9_AA_3_AA_9_AA_4_AA_9_AA_5_AA_9_AA_6_AA_9_AA_7_AA_9_AA_8_AAFA_1_1_APBRAFBMADFB_-1_0_-1_BMARAEBKFC_-1_1_ADFD_1_BRAFBMAPBRAFBMADFE_1_AP_0_AFBM_-1_AP_0_AFBMADFF_0_1_APBRAFBMADFG_0_-1_-1_FH_-1_-1_APEQADFIEU_4_DLED_-1_0_DSBQAF_-1_0_DSBQAF_1_1_BMAF_0_-1_BMAF_0_-1_BMAF_0_-1_BMAF_0_APBRAF_0_-1_BMA
429,394,394,16,956,0,-956,0,EY_9_AA_9_AA_1_AA_9_AA_2_AA_9_AA_3_AA_9_AA_4_AA_9_AA_5_AA_6_AA_9_AA_7_AA_9_AA_8_AA_9_AA_1_ADFA_1_1_APBRAFBMADFB_-1_0_-1_BMAFBMADFC_-1_1_APBRAFBMADFD_1_BRBMADAFBMADFE_1_AP_0_AFBM_-1_AP_0_AFBMADFF_0_1_APBRAFAPBRFG_0_-1_APFH_6_AZ_18_-1_-1_APEQAFBMADFIEU_4_DLED_-1_0_DSBQAF_-1_0_DSBQAF_1_1_BMAF_0_-1_BMAF_0_-1_BMAF_0_-1_BMAF_0_APBRAF_0_-1_BMA
430,425,425,17,963,986,23,0,EY_9_AA_9_AA_1_AA_9_AA_2_AA_9_AA_3_AA_9_AA_4_AA_9_AA_5_BMAF_0_-1_AA_7_AA_9_AA_8_AA_9_AA_1_ADFA_1_1_APBRAFBMADFB_-1_0_-1_BMAFBMADFC_-1_1_APBRAFBMADFD_1_BRBMADAFBMADFE_1_AP_0_AFBM_-1_AP_0_AFBMADFF_0_1_APBRAFBMADFG_0_-1_APFH_-1_-1_APADFIEU_4_DLED_-1_0_DSBQAF_-1_0_DSBQAF_1_1_AA_6_AA_9_BMAF_0_-1_BMAF_0_-1_BMAF_0_APBRAF_0_-1_BMA
431,285,285,19,964,0,-964,0,EY_9_AA_9_AA_1_BMAF_2_AA_9_AA_3_AA_9_AA_4_AW_13_AC_5_AA_9_AA_6_AA_9_AA_7_AA_9_AA_8_AA_9_AA_1_ADFA_1_1_APBIDDDMADFB_-1_-1_BMAFBMFCBRAFAD_1_BRAPBRBRAFADFD_-1_1_APBRAFAPBRFE_1_BMADAFAP_0_ADFF_0_1_BMEOAFBMADFG_0_-1_ADFH_-1_-1_APBRAFBMADFIEU_4_DLED_-1_0_DSBQAF_-1_0_DSBQAF_1_1_BMAF_0_-1_BMAF_0_-1_BMAF_0_-1_BMAF_0_APBRAF_0_-1_AA_9
432,377,428,20,964,0,-964,51,EY_9_AA_9_AAAA_2_AA_9_AA_3_AA_9_AA_4_AA_9_AA_5_AA_9_AA_6_AA_9_AA_7_AA_9_AA_8_AA_9_AA_1_ADFA_1_1_APBRAFBMADFB_-1_0_-1_BMAFBMADFC_-1_1_ADFD_1_BRAFBMAPBRAFBMADFE_1_AP_0_AFBM_1_APBRAFBMADFF_0_-1_AP_0_AFBMADFG_0_-1_-1_FH_-1_-1_APEQADFIEU_4_DLED_-1_0_DSBQAF_-1_0_DSBQAF_1_1_BMAF_0_-1_BMAF_0_-1_BMAF_0_-1_BMAF_0_APBRAF_0_-1_BMA
433,191,191,9,965,0,-965,0,16
434,426,426,10,965,978,13,0,EY_1_1_APBRAFBMADFA_-1_0_APBRAFBMADFB_-1_1_APBRAFBMADFC_1_0_APBRAFBMADFD_1_-1_APBRAFBMADFE_0_APBRAFBMADFF_0_-1_APBRAFBMADFG_-1_-1_APBRAFBMADFHEU_4_DLED_-1_0_DSBQAF_-1_0_DSBQAF_1_1_BMAF_0_-1_BMAF_0_-1_BMAF_0_-1_BMAF_0_-1_BMAF_0_-1_BMA
435,401,401,20,966,1007,41,0,EY_9_AA_9_AA_1_AA_9_AA_2_AA_9_AA_3_AA_9_AA_4_AA_9_AA_5_AA_9_AA_6_AA_9_AA_7_AA_9_AA_8_AAFA_1_1_APBRAFBMADFB_-1_0_-1_BMAFBMADFC_-1_1_ADFD_1_BRAFBMAPBRAFBMADFE_1_AP_0_AFBM_-1_AP_0_AFBMADFF_0_1_APDGAHBRAFBMADFG_0_-1_-1_FH_-1_-1_AFBMADFIEU_4_DLED_-1_0_DSBQAF_-1_0_DSBQAF_1_1_BMAF_0_-1_BMAF_0_-1_BMAF_0_-1_BMAF_0_APBRAF_0
436,394,429,17,966,0,-966,35,EY_9_AA_9_AA_1_AA_9_AA_2_AA_9_AA_3_AA_9_AA_4_AA_9_AA_5_AA_6_AA_9_AA_7_AA_9_AA_8_AA_9_AA_1_ADFA_1_1_APBRAFBMADFB_-1_0_-1_BMAFBMADFC_-1_1_APBRAFBMADFD_1_BRBMADAFBMADFE_1_AP_0_AFBM_-1_AP_0_AFBMADFF_0_1_APBRAFAPBRFG_0_-1_APFH_6_AZ_18_-1_-1_APEQAFBMADFIEU_4_DLED_-1_0_DSBQAF_-1_0_DSBQAF_1_1_BMAF_0_-1_BMAF_0_-1_BMAF_0_-1_BMAF_0_APBRAF_0_-1_BMA
437,138,138,18,967,997,30,0,EY_9_AA_9_AA_1_AA_9_AA_2_AA_9_AA_3_AA_9_AA_4_AA_9_AA_5_AA_9_AA_6_AA_9_AA_7_AA_9_AA_8_AA_9_AA_1_ADFA_1_1_APBRAFBMADFB_-1_0_-1_0_-1_BMAFBMADFC_-1_1_APBRAFBMADFD_-2_BRAPBRAFBMADFE_1_AP_0_AFBM_-1_AP_0_AFBMADFF_1_AP_0_1_APBRAFBMADALDJ_20_53_FGAPFH_-1_BQBU_-83_-1_APEQAFBMADFIEU_4_DLED_-1_0_DSBQAF_-1_0_DSBQAF_1_1_BMAF_0_-1_BMAF_0_-1_BMAF_0_-1_BMAF_0_APBRAF_0_-1_BMA
438,427,427,16,967,984,17,0,EY_9_AA_9_AA_1_AA_9_AA_2_AA_9_AA_3_AA_9_AA_4_AA_9_AA_5_AA_9_AA_6_AA_9_AA_7_AA_9_AA_8_AA_9_AA_1_ADFA_1_1_APBRAFBMADFB_-1_0_-1_BMFC_-1_1_APBRAFBMADFD_1_BRAPBRAFBMADFE_1_AP_0_AFBM_-1_AP_0_AFBMADFF_0_1_APBRAFBMADFG_0_-1_APFH_-1_-1_APEQAFBMADFIEU_4_DLED_-1_0_DSBQAF_-1_0_DSBQAF_1_1_0_-1_BMAF_0_-1_BMAF_0_-1_BMAF_0_APBRAF_0_-1_BMA
439,400,400,10,968,0,-968,0,7
440,337,337,14,974,0,-974,0,EY_9_AA_9_AA_1_AA_9_AA_2_AA_9_AA_3_AA_9_AA_4_AA_9_AA_5_AA_9_AA_6_AA_9_AA_7_AA_9_AA_8_AA_9_AA_1_ADFA_1_1_APBRAFBMADFB_-1_0_-1_BM_0_-1_BMAFBMADFC_-1_ADFD_1_FE_-1_APBR_0_AFADFF_0_1_-26_AJAPBRAFBMADFG_0_-1_1_APBRBMADFH_-1_1_-1_APAFBMADFIEU_4_DLED_-1_0_DSBQAF_54_77_-1_0_DSBQAF_1_1_BMAF_0_-1_BMAF_0_-1_BMAF_0_-1_BMAF_0_APBRAF_0_-1_BMA
441,297,297,10,975,0,-975,0,EY_9_AA_9_AA_1_AA_9_AA_9_AA_3_AA_9_AA_4_AA_9_AA_5_AA_9_AA_6_AA_9_AA_7_AA_9_AA_8_AA_9_AA_1_ADFABRAFBMAD_1_1_APBRAFBMADFBEF_-7_ER_-1_0_APBRAFBMADFC_-1_1_APBRBRAFBMADFD_1_0_APBRAFBMAD_-59_13_FE_1_-1_APBRADAFBMADAPBRAFFF_0_1_APBRAFBMADFG_0_-1_ADFH_-1_-1_APBR_-1_APBRAFBMADFIEU_4_DLED_-1_0_DSBQAF_-1_0_DSBQAF_1_1_BMAF_0_-1_BMAF_0_-1_BMAF_0_-1_BMAF_0_APBRAF_0_-1_BMA
442,280,280,12,977,0,-977,0,EY_9_AA_9_AA_1_AA_9_AA_2_AA_9_AA_3_AA_9_AA_4_AA_9_AA_5_AA_9_AA_6_AA_9_AA_7_AA_9_AA_8_AA_9_AA_1_ADFA_1_1_APBRAFBMADFB_-1_0_-1_BM_0_-1_BMAFBMADFC_-1_APBRAFADFD_1_BMADFE_-1_APBR_0_AFBMADFF_0_1_-26_AJAPBRAFBMADFG_0_-1_1_APBRBMADFH_-1_1_-1_APAFBMADFIEU_4_DLED_-1_0_DSBQAF_54_77_-1_0_DSBQAF_1_1_BMAF_0_-1_BMAF_0_-1_BMAF_0_-1_BMAF_0_APBRAF_0_-1_BMA
443,373,373,9,977,0,-977,0,EY_9_AA_9_AA_1_AA_9_AA_2_AA_9_AA_3_AA_9_AA_4_AA_9_AA_5_AA_9_AA_6_AA_9_AA_7_AA_9_AA_8_AA_9_AA_1_ADFA_1_1_APBRAFBMADFB_-1_0_APBRAFBMADFC_-1_1_APBRAFBMADFD_5_-1_BMBRAFBMADFE_1_-1_APBRAFBMADFF_0_APBRAFBMADFG_0_-1_APBRAFBMADFH_-1_-1_APBRAFBMADFIEU_4_DLED_-1_0_DSBQAF_-1_0_DSBQAF_1_1_BMAF_0_-1_BMAF_0_-1_BMAF_0_-1_BMAF_0_-1_BMAF_0_-1_BMA
444,406,406,15,979,0,-979,0,4
445,431,431,20,979,0,-979,0,EY_9_AA_9_AA_1_BMAF_2_BMAF_2_AAAA_9_AA_3_AA_9_AA_4_AW_13_AC_5_AA_9_AA_6_AA_9_AA_7_AA_9_AA_8_AA_9_AA_1_ADFA_1_1_APBIDDDMADFB_-1_-1_BMAFBMFCBRAFAD_1_BRAPBRBRAFADFDAADK_-1_1_APBRAFAPBRFE_1_BMADAFAP_0_ADFF_0_1_BMEOAFBMADFG_0_-1_ADFH_-1_-1_APBRAFBMADFIEU_4_DLED_-1_0_DSBQAF_-1_0_DSBQAF_1_1_BMAF_0_-1_BMAF_0_-1_BMAF_0_-1_BMAF_0_APBRAF_0_-1_AA_9
446,433,433,10,980,0,-980,0,EY_9_AA_9_AA_1_AA_9_AA_2_AA_9_AA_3_AA_9_AA_4_AA_9_AA_5_AA_9_AA_6_AA_9_AA_7_AA_9_AA_8_AA_9_AA_1_ADFA_1_1_APDQBRAFBMADFB_-1_0_-1_BM_-1_0_ADFC_-1_1_APBRAFBMADFD_1_BRAPBRAFBMADFE_1_-1_AP_0_AFBMADFF_0_1_APBRAFBMADFG_0_-1_APFH_-1_-1_APEQAFBMADFIEU_4_DLED_-1_0_DSBQAFAFBMDSBQAF_1_1_BMAF_0_-1_BMAF_0_-1_BMAF_0_-1_BMAF_0_APBRAF_0_-1_BMA
447,436,436,18,981,0,-981,0,EY_9_AA_9_AA_1_AA_9_AA_2_AA_9_AA_3_AA_9_AA_4_AA_9_AA_5_AA_6_AA_9_AA_7_AA_9_AA_8_AA_9_AAFA_1_1_APBRAFBMADFB_-1_0_-1_BMAFBMADFC_-1_1_APBRAFBMADFD_1_BRBMADAFBMADFE_1_AP_0_AFBM_-1_AP_0_AFBMADFF_0_1_APBRAFAPBRFG_0_-1_APFH_6_AZ_18_-1_-1_APEQAFBMADFIEU_4_DLED_-1_0_DSBQAF_-1_0_DSBQAF_1_1_BMAF_0_-1_BMAF_0_-1_BMAF_0_-1_BMAF_0_APBRAF_0_-1_BMA
448,435,435,21,981,0,-981,0,EY_9_AA_9_AA_1_AA_9_AA_2_AA_9_AA_3_AA_9_AA_4_AA_9_AA_5_AA_9_AA_6_AA_9_AA_7_AA_9_AA_8_AAFA_1_1_APBRAFBMADFB_-1_0_-1_BMAFBMADFC_-1_1_ADFD_1_BRAFBMAPBRAFBMADFE_1_AP_0_AFBM_-1_AP_0_AFBMADFF_0_1_APBMADFG_0_-1_-1_FH_-1_-1_AFBMADFIEU_4_DLED_-1_0_DSBQAF_-1_0_DSBQAF_1_1_BMAF_0_-1_BMAF_0_-1_BMAF_0_-1_BMAF_0_APBRAF_0
449,386,415,16,982,0,-982,29,EY_9_AA_9_AA_1_AA_9_AA_2_AA_9_AA_3_AA_9_AA_4_AA_9_AA_5_AA_9_AA_6_AA_9_AA_7_AA_9_AA_8_AAFA_1_1_APBRAFBMADFB_-1_0_-1_BMAFBMADFC_-1_1_ADFD_1_BRAPERDGBGATFE_1_AP_0_AFBM_-1_AP_0_AFBMADFF_0_1_APBRAFBMADFG_0_-1_-1_FH_-1_-1_APEQAFBMADFIEU_4_DLED_-1_0_DSBQAF_1_-4_BMBGAF_1_1_BMAF_0_-1_BMAF_0_-1_BMAF_0_-1_BMAF_0_APBRAF_0_-1_BMA
450,437,437,19,982,985,3,0,EY_9_AA_9_AA_1_AA_9_AA_2_AA_9_AA_3_AA_9_AA_4_AA_9_AA_5_AA_9_AA_6_AA_9_AA_7_AA_9_AA_8_AA_9_AA_1_ADFA_1_1_APBRAFBMADFB_-1_0_-1_0_-1_BMAFBMADFC_-1_1_APBRAFBMADFD_-2_BRAPBRAFBMADFE_1_AP_0_AFBM_-1_AP_0_AFBMADFF_1_AP_0_1_APBRAFBMADALDJ_20_53_FGFH_-1_BQBU_-83_-1_APEQAFBMADFIEU_4_DLED_-1_0_DSBQAF_-1_0_DSBQAF_1_1_BMAF_0_-1_BMAF_0_-1_BMAF_0_-1_BMAF_0_APBRAF_0_-1_BMA
451,384,384,20,983,0,-983,0,EY_9_AA_9_AA_1_BMAFAA_2_AA_9_AA_3_AA_9_AA_4_AW_13_AC_5_AA_9_AA_6_AA_9_AA_7_AA_9_AA_8_AA_9_AA_1_ADFA_1_1_APBIDDDMADFB_-1_0_-1_BMADADAFBMAFBMFCBRAFAD_1_BRAPBRBRAFADFD_-1_1_APBRBRAFAPBRFE_1_-1_BMAFAP_0_ADFF_0_1_BMEOAFBMADFG_0_-1_ADFH_-1_-1_APBRAFBMADFIEU_4_DLED_-1_0_DSBQAF_-1_0_DSBQAF_1_1_BMAF_0_-1_BMAF_0_-1_BMAF_0_-1_BMAF_0_APBRAF_0_-1_AA_9
452,302,302,10,984,0,-984,0,EY_9_AA_9_AA_1_AA_9_AA_2_AA_9_AA_3_AA_9_AA_4_AA_9_AA_5_AA_9_AA_6_AA_9_AA_7_AA_9_AA_8_AA_9_AA_1_ADFA_1_1_APBRAFBMADFB_-1_0_BRAFBMADADFC_-1_1_APBRADFD_1_BRAPBRAFBMADFE_1_EFBMADFF_0_1_APBRAFBMADFG_0_-1_AP_-1_BMAFBMFH_-1_-1_APBRAFBMADFIEU_4_DLED_-1_0_DSBQAF_-1_0_DSBQAF_1_1_BMAF_0_-1_BMAF_0_-1_BMAF_0_-1_BMAF_0_APBRAF_0_-1_BMA
453,368,368,15,986,996,10,0,EY_9_AA_9_AA_1_AA_9_AA_2_AA_9_AA_3_AA_9_AA_4_AA_9_AA_5_AA_6_AA_9_AA_7_AA_9_AA_8_AA_9_AA_1_ADFA_1_1_APBRAFBMADFB_-1_AFBMADFC_-1_1_APBRAFBMADFD_1_BRBMADAFBMADFE_1_AP_0_AFBM_-1_AP_0_AFBMADFF_0_1_APBRAFAPBRFG_0_-1_APFH_-1_-1_APEQAFBMADFIEU_4_DLED_-1_0_DSBQAF_-1_0_DSBQAF_1_1_BMAF_0_-1_BMAF_0_-1_BMAF_0_-1_BMAF_0_APBRAF_0_-1_BMA
454,418,418,11,990,0,-990,0,EY_9_AA_9_AA_1_AA_9_AA_9_AA_3_AA_9_AA_4_AA_9_AA_5_AA_9_AA_6_AA_9_AA_7_AA_9_AA_8_AA_9_AA_1_ADFABRAFBMAD_1_1_APBRAFBMADFBEF_-7_ER_-1_0_APBRAFBMADFC_-1_1_APBRBRAFBMADFD_1_0_APBRAFBMAD_-59_13_FE_1_-1_APBRADAFBMADAPBRAFFF_0_1_APBRAFBMADFG_0_-1_ADFH_-1_-1_APBR_-1_APBRAFBMA
455,440,440,15,991,0,-991,0,EY_9_AA_9_AA_1_AA_9_AA_2_AA_9_AA_3_AA_9_AA_4_AA_9_AA_5_AA_9_AA_6_AA_9_AA_7_AA_9_AA_8_AA_9_AA_1_ADFA_1_1_APBRAFBMADFB_-1_0_-1_BM_0_-1_BMAFBMADFC_-1_ADFD_1_FE_-1_APBR_0_AFADFF_0_1_-26_AJAPBRAFBMADFG_0_-1_1_APBRBMADFH_-1_1_-1_APAFBMADFIEU_4_DLED_-1_0_DSBQAF_54_77_-1_0_DSBQAF_1_1_BMAF_0_-1_BMAF_0_-1_BMAF_0_-1_BMAF_0_APBRAF_0_-1_BMA
456,443,443,10,992,993,1,0,EY_9_AA_9_AA_1_AA_9_AA_2_AA_9_AA_3_AA_9_AA_4_AA_9_AA_5_AA_9_AA_6_AA_9_AA_7_AA_9_AA_8_AA_9_AA_1_ADFA_1_1_APBRAFBMADFB_-1_0_APBRAFBMADFC_-1_1_APBRAFBMADFD_5_-1_BMBRAFBMADFE_1_-1_APBRAFBMADFF_0_APBRAFBMADFG_0_-1_APBRAFBMADFH_-1_-1_APBRAFBMADFIEU_4_DLED_-1_0_DSBQAF_-1_0_DSBQAF_1_1_BMAF_0_-1_BMAF_0_-1_BMAF_0_-1_BMAF_0_-1_BMAF_0_-1_BMA
457,420,420,15,993,0,-993,0,EY_9_AA_9_AA_1_AA_9_AA_2_AA_9_AA_3_AA_9_AA_4_AA_9_AA_5_AA_9_AA_6_AA_9_AA_7_AA_9_AAAPBRAFAA_1_ADFA_1_1_APBRAFBMADFB_-1_0_-1_BMAFBMADFC_-1_1_8_AA_9_BMADFD_1_BRAPBRAFBMADFE_1_AP_0_AFBM_-1_AP_0_AFBMADFF_0_1_APBRAFBMADFG_0_-1_APFH_-1_-1_APEQAFBMADFIEU_4_DLED_-1_0_DSBQAF_-1_0_DSBQAF_1_1_BMAF_0_-1_BMAF_0_-1_BMAF_0_-1_BMAF_0_APBRAF_0_-1_BMA
458,290,290,13,994,0,-994,0,EY_9_AA_9_AA_1_AA_9_AA_2_AA_9_AA_3_AA_9_AA_4_AA_9_AA_5_AA_9_AA_6_AA_9_AA_7_AA_9_AA_8_AA_-31_87_9_AA_1_ADFA_1_1_APBRAFBMADFB_-1_0_-1_BM_0_-1_BMAFBMADFC_-1_APBRAFADFD_1_BMADFE_-4_APBR_2_AFBMADFF_0_1_-26_AJAPBRAFBMADFG_-1_3_5_APBRBMADFH_-1_1_-1_APAFBMADFIEU_4_DLED_-1_0_DSBQAF_54_77_-1_0_DSBQAF_1_1_BMAF_0_-1_BMAF_0_-1_BMAF_0_-1_BMAF_0_APBRAF_0_-1_BMA
459,375,375,16,994,0,-994,0,EY_9_AA_9_AA_1_AA_9_AA_2_AA_9_AA_3_AA_9_AA_4_AA_9_AA_5_AA_6_AA_9_AA_7_AA_9_AA_8_AA_9_AA_1_ADFA_1_1_APBRAFBMADFB_-1_0_-1_BMAFBMADFC_-1_1_APBRAFBMADFDAFBMADFE_1_AP_0_AFBM_-1_AP_0_AFBMADFF_0_1_APBRAFAPBRFG_0_-1_APAA_66_-8_FH_-1_-1_APEQAFBMADFIEU_4_DLED_-1_0_DSBQAF_-1_0_DSBQAF_1_1_BMAF_0_-1_BMAF_0_-1_BMAF_0_-1_BMAF_0_APBRAF_0_-1_BMA
460,442,442,13,994,0,-994,0,EY_9_AA_9_AA_1_AA_9_AA_2_AA_9_AA_3_AA_9_AA_4_AA_9_AA_5_AA_9_AA_6_AA_9_AA_7_AA_9_AA_8_AA_9_AA_1_ADFA_1_1_APBRAFBMADFB_-1_0_-1_BM_0_-1_BMAFBMADFC_-1_APBRAFADFD_1_BMADFE_-1_APBR_0_AFBMADFF_0_1_-26_AJAPBRAFBMADFG_0_-1_1_APBRBMADFH_-1_1_-1_APAFBMADFIEU_4_DLED_-1_0_DSBQAF_54_77_-1_0_DSBQAF_1_1_BMAF_0_-1_BMAF_0_-1_BMAF_0_-1_BMAF_0_APBRAF_0_-1_BMA
461,444,444,16,994,0,-994,0,4
462,73,73,2,996,0,-996,0,EY_9_AA_9_AA_1_AA_9_AA_2_AA_9_AA_3_AA_9_AA_4_AA_9_AA_5_AA_9_AA_6_AA_9_AA_7_AA_9_AA_8_AA_9_AA_1_ADFA_1_BMADFB_-1_BMADFC_-1_1_APBRAFBMADFD_1_0_APBRBRAFBMFE_1_-1_APBRAFBMADFF_0_1_APBRAFBMADFG_-1_-1_APAFBMADADFHEU_4_DLED_-1_0_DSBQAF_-1_0_DSBQAF_1_1_BMAF_0_-1_BMAF_0_-1_BMAF_0_-1_BMAF_0_-1_BMAF_0_-1_BMA
463,452,452,11,999,0,-999,0,EY_9_AA_9_AA_1_AA_9_AA_2_AA_9_AA_3_AA_9_AA_4_AA_9_AA_5_AA_9_AA_6_AA_9_AA_7_AA_9_AA_8_AA_9_AA_1_ADFA_1_1_APBRAFBMADFB_-1_0_BRAFBMADADFC_-1_1_APBRADFD_1_BRAPBRAFBMADFE_1_EFBMADFF_0_1_APBRAFBMADFG_0_-1_AP_-1_BMAFBMFH_-1_-1_APBRAFBMADFIEU_4_DLED_-1_0_DSBQAF_-1_0_DSBQAF_1_1_BMAF_0_-1_BMAF_0_-1_BMAF_0_-1_BMAF_0_APBRAF_0_-1_BMA
464,426,426,10,1006,0,-1006,0,7
465,455,455,16,1008,0,-1008,0,EY_9_AA_9_AA_1_AA_9_AA_2_AA_9_AA_3_AA_9_AA_4_AA_9_AA_5_AA_9_AA_6_AA_9_AA_7_AA_9_AA_8_AA_9_AA_1_ADFA_1_1_APBRAFBMADFB_-1_0_-1_BM_0_-1_BMAFBMADFC_-1_ADFD_1_FE_-1_APBR_0_AFAD_-53_BRBLERFF_0_1_-26_AJAPBRAFBMADFG_0_-1_1_APBRBMADFH_-1_1_-1_APAFBMADFIEU_4_DLED_-1_0_DSBQAF_54_77_-1_0_DSBQAF_1_1_BMAF_0_-1_BMAF_0_-1_BMAF_0_-1_BMAF_0_APBRAF_0_-1_BMA
466,285,285,19,1009,1013,4,0,EY_9_AA_9_AA_1_BMAFAA_2_AA_9_AA_3_AA_9_AA_4_AW_13_AC_5_AA_9_AA_6_AA_9_AA_7_AA_9_AA_8_AA_9_AA_1_ADFA_1_1_APBIDDDMADFBAFBMADAFBMFCBRAFAD_1_BRAPARAXAFADFD_-1_1_APBRAFAPBRFE_1_-1_BMAFAP_0_ADFF_0_1_BMEO_-1_BMADFG_0_-1_ADFH_-1_-1_APBRAFBMADFIEU_4_DLED_-1_0_DSBQAF_-1_0_DSBQAF_1_1_BMAF_0_-1_BMAF_0_-1_BMAF_0_-1_BMAF_0_APBRAF_0_-1_AA_9
467,461,461,17,1009,0,-1009,0,4
468,459,459,17,1009,0,-1009,0,EY_9_AA_9_AA_1_AA_9_AA_2_AA_9_AA_3_AA_9_AA_4_AA_9_AA_5_AA_6_AA_9_AA_7_AA_9_AA_8_AA_9_AA_1_ADFA_1_1_APBRAFBMADFB_-1_0_-1_BMAFBMADFC_-1_1_APBRAFBMADFDAFBMADFE_1_AP_0_AFBM_-1_AP_0_AFBMADFF_0_1_APBRAFAPBRFG_0_-1_APAA_66_-8_FH_-1_-1_APEQAFBMADFIEU_4_DLED_-1_0_DSBQAF_-1_0_DSBQAF_1_1_BMAF_0_-1_BMAF_0_-1_BMAF_0_-1_BMAF_0_APBRAF_0_-1_BMA
469,428,428,20,1010,0,-1010,0,EY_9_AA_9_AA_1_AA_9_AA_2_AA_9_AA_3_AA_9_AA_4_AA_9_AA_5_AA_9_AA_6_AA_9_AA_7_AA_9_AA_8_AAFA_1_1_APBRAFBMADFB_-1_0_-1_BMARAEBKFC_-1_1_ADFD_1_BRAFBMAPBRAFBMADFE_1_AP_0_AFBM_-1_AP_0_AFBMADFF_0_1_APBRAFBMADFG_0_-1_-1_FH_-1_-1_APEQADFIEU_4_DLED_-1_0_DSBQAF_-1_0_DSBQAF_1_1_BMAF_0_-1_BMAF_0_-1_BMAF_0_-1_BMAF_0_APBRAF_0_-1_BMA
470,460,460,14,1011,0,-1011,0,EY_9_AA_9_AA_1_AA_9_AA_2_AA_9_AA_3_AA_9_AA_4_AA_9_AA_5_AA_9_AA_6_AA_9_AA_7_AA_9_AA_8_AA_9_AA_1_ADFA_1_1_APBRAFBMADFB_-1_0_-1_BM_0_-1_BMAFBMADFC_-1_APBRAFADFD_1_BMADFE_-1_APBR_0_AFBMADFF_0_1_-26_AJAPBRAFBMADFG_0_-1_1_APBRBMADFH_-1_1_-1_ADFIEU_4_DLED_-1_0_DSBQAF_54_77_-1_0_DSBQAF_1_1_BMAF_0_-1_BMAF_0_-1_BMAF_0_-1_BMAF_0_APBRAF_0_-1_BMA
471,458,458,14,1011,0,-1011,0,EY_9_AA_9_AA_1_AA_9_AA_2_AA_9_AA_3_AA_9_AA_4_AA_9_AA_5_AA_9_AA_6_AA_9_AA_7_AA_9_AA_8_AA_-31_87_9_AA_1_ADFA_1_1_APBRAFBMADFB_-1_0_-1_BM_0_-1_BMAFBMADFC_-1_APBRAFADFD_1_BMADFE_-4_APBR_2_AFBMADFF_0_1_-26_AJAPBRAFBMADFG_-1_3_5_APBRBMADFH_-1_1_-1_APADFIEU_4_DLED_-1_0_DSBQAF_54_77_-1_0_DSBQAF_1_1_BMAF_0_-1_BMAF_0_-1_BMAF_0_-1_BMAF_0_APBRAF_0_-1_BMA
472,463,463,12,1014,0,-1014,0,EY_9_AA_9_AA_1_AA_9_AA_2_AA_9_AA_3_AA_9_AA_4_AA_9_AA_5_AA_9_AA_6_AA_9_AA_7_AA_9_AA_8_AA_9_AA_1_ADFA_1_1_APBRAFBMADFB_-1_0_BRAFBMADADFC_-1_1_APBRADFD_1_BRAPBRAFBMADFE_1_EFBMADFF_0_1_APBRAFBMADFG_0_-1_AP_-1_BMAFBMFH_-1_-1_APBRAFBMADFIEU_4_DLED_-1_0_DSBQAF_-1_0_DSBQAF_1_1_BMAF_0_-1_BMAF_0_-1_BMAF_0_-1_BMAF_0_APBRAF_0_-1_BMA
